TAGTCAGGTCTGCCATTTA -> AGTCAGGTCTGCCATTTAC
CAGATTTTGGTCGAAAAGA -> AGATTTTGGTCGAAAAGAA
TTGCCCCACCGCCGGTGAA -> TGCCCCACCGCCGGTGAAG
GCGCATACCCCGCTAAGAA -> CGCATACCCCGCTAAGAAA
AGTCACAAACGAATAGCAT -> GTCACAAACGAATAGCATG
AGTGCCGAATGAACCAATG -> GTGCCGAATGAACCAATGC
AGCGTGTGGAGAGCCTAGC -> GCGTGTGGAGAGCCTAGCC
CTAGCCAGACGCTGTTTCT -> TAGCCAGACGCTGTTTCTT
TACATATACCGTGGGTCAG -> ACATATACCGTGGGTCAGT
CCTGTTCCAAGCGTGTGGA -> CTGTTCCAAGCGTGTGGAG
TAGCTACTCGCAGTAGATG -> AGCTACTCGCAGTAGATGG
ATATGTCAAATTATCTGCA -> TATGTCAAATTATCTGCAT
ATCTAGAGCCAAGCTTCAG -> TCTAGAGCCAAGCTTCAGG
GATAAACTTCGTCCAAAAA -> ATAAACTTCGTCCAAAAAG
TGCGAAAACAGAAAATTCG -> GCGAAAACAGAAAATTCGG
GAATAAACCGGCTGATCGC -> AATAAACCGGCTGATCGCG
CTCCCGTTCTTGTTACATT -> TCCCGTTCTTGTTACATTA,TCCCGTTCTTGTTACATTG,TCCCGTTCTTGTTACATTT,TCCCGTTCTTGTTACATTA
TCTTGTTACATTTGATGTG -> CTTGTTACATTTGATGTGT
CGTGTTCCCAGCGTGTTCA -> GTGTTCCCAGCGTGTTCAA
GGCTTCGCGCACTACCCAT -> GCTTCGCGCACTACCCATT
ACTCGCAGTTTCTGTTGGT -> CTCGCAGTTTCTGTTGGTA
ATTGCCATAGTCGGTGATT -> TTGCCATAGTCGGTGATTC
AAAGTTCTTCTGGTCGAAT -> AAGTTCTTCTGGTCGAATT
CTAATATCGATCCATGACT -> TAATATCGATCCATGACTG
CCGCTCCGGATGTTGCAGC -> CGCTCCGGATGTTGCAGCA
ATTGCTTTCGGAACAATCG -> TTGCTTTCGGAACAATCGG
TGTCTATACGGACAATCTA -> GTCTATACGGACAATCTAA
AGGTCGGGGGGGTCGTGCA -> GGTCGGGGGGGTCGTGCAC
CATTGAGGGCTTAGCAACC -> ATTGAGGGCTTAGCAACCA
ACAGATTTTGGTCGAAAAG -> CAGATTTTGGTCGAAAAGA
GCCATAGTCGGTGATTCGT -> CCATAGTCGGTGATTCGTC
ATCTCATCACCTCAGCTTG -> TCTCATCACCTCAGCTTGC
ACGAATAGCATGAGGTCAG -> CGAATAGCATGAGGTCAGT
GGACAATCTAATATCGATC -> GACAATCTAATATCGATCC
CTAGGTGGTATGTGGCGTG -> TAGGTGGTATGTGGCGTGT
CGCCGGTGAAGCCAGGAAG -> GCCGGTGAAGCCAGGAAGT
GAAGCCAGGAAGTACCACC -> AAGCCAGGAAGTACCACCA
GGAATGAAATAAGACTAGG -> GAATGAAATAAGACTAGGG
TTCGTCCAAAAAGGGGCTG -> TCGTCCAAAAAGGGGCTGT
GGGGAACGCAATTAGGGAG -> GGGAACGCAATTAGGGAGA
TGGTCGGATCAACCTTCCG -> GGTCGGATCAACCTTCCGT
AATCATGATCGTATAAATG -> ATCATGATCGTATAAATGC
AGTGCGGTGGAACGGGCCG -> GTGCGGTGGAACGGGCCGC
GCGACCGACACGTGGTTGG -> CGACCGACACGTGGTTGGC
TAGCAGTGTATAACCAAAG -> AGCAGTGTATAACCAAAGT
CAATCGGCAGAGATCTATT -> AATCGGCAGAGATCTATTA
TACGTATGTCGTTAAACCT -> ACGTATGTCGTTAAACCTT
CTTCGTCCAAAAAGGGGCT -> TTCGTCCAAAAAGGGGCTG
CTTCACGGGGATCCTATCA -> TTCACGGGGATCCTATCAC
GTAGCGGTCTCGATGGAGC -> TAGCGGTCTCGATGGAGCA
GGCCGCTGAGACCAGAATG -> GCCGCTGAGACCAGAATGA
TCAGTACAATTGGGCTGTA -> CAGTACAATTGGGCTGTAT
TCGATGGAGCAACAGGGTG -> CGATGGAGCAACAGGGTGC
CATAGTCGGTGATTCGTCC -> ATAGTCGGTGATTCGTCCT
CGAGAACGTATTGGCAAAA -> GAGAACGTATTGGCAAAAA
CATCTACGATCTTCCTGTT -> ATCTACGATCTTCCTGTTC
GTTACATTTGATGTGTACT -> TTACATTTGATGTGTACTG
CGAAGAATATGGTGCATAG -> GAAGAATATGGTGCATAGC
TTCCTGTTCCTTATGGTTC -> TCCTGTTCCTTATGGTTCG
CTTCCTGTTCCTTATGGTT -> TTCCTGTTCCTTATGGTTC
GTTGCAGCACTACTATTGG -> TTGCAGCACTACTATTGGG
TGCCATAGTCGGTGATTCG -> GCCATAGTCGGTGATTCGT
TCATTCTGTTAGGTATACG -> CATTCTGTTAGGTATACGA
GGGCTCGTAGCGGTCTCGA -> GGCTCGTAGCGGTCTCGAT
AGGTGCGTGACTCTGGCGG -> GGTGCGTGACTCTGGCGGA
GTCTCGATGGAGCAACAGG -> TCTCGATGGAGCAACAGGG
GTATAGCAATTGCCATAGT -> TATAGCAATTGCCATAGTC
TATGATCCATTAAAGTCTA -> ATGATCCATTAAAGTCTAT
GCGGACGGCTAAATCGCCA -> CGGACGGCTAAATCGCCAG
AGAGCCAAGCTTCAGGTGA -> GAGCCAAGCTTCAGGTGAC
ATTAAAGTCTATTCTATCC -> TTAAAGTCTATTCTATCCT
CAGGATTATGTTTATTACC -> AGGATTATGTTTATTACCG
GGGGCTTCGCGCACTACCC -> GGGCTTCGCGCACTACCCA
CCAGACGGTAAGTGAATGA -> CAGACGGTAAGTGAATGAA
TGGTATGTGGCGTGTTCCC -> GGTATGTGGCGTGTTCCCA
ATTCTGTTAGGTATACGAC -> TTCTGTTAGGTATACGACT
TACAATTGGGCTGTATTGA -> ACAATTGGGCTGTATTGAT
GGGTCAGTACAATTGGGCT -> GGTCAGTACAATTGGGCTG
GGAGATTCACATGTCTGGC -> GAGATTCACATGTCTGGCT
TGCCTGCGGTCTCCCGTTC -> GCCTGCGGTCTCCCGTTCT
ATTACCGGGTTTCTGACTG -> TTACCGGGTTTCTGACTGG
GAAATAAGACTAGGGTTGC -> AAATAAGACTAGGGTTGCT
ATCAGGATTATGTTTATTA -> TCAGGATTATGTTTATTAC
CCTCGTTTTGTCGGAGGAG -> CTCGTTTTGTCGGAGGAGT
GCTGTGCCCTGGAACCCTC -> CTGTGCCCTGGAACCCTCA
ACTGAGCGCATACCCCGCT -> CTGAGCGCATACCCCGCTA
AAACCTTGTCCTTCTGTCG -> AACCTTGTCCTTCTGTCGT
GCTGCACGTGCTATACACC -> CTGCACGTGCTATACACCG
TAGTGGCATAGGAGATTCA -> AGTGGCATAGGAGATTCAC
CTACCCATTACGGATAACA -> TACCCATTACGGATAACAA
CATTAAAGTCTATTCTATC -> ATTAAAGTCTATTCTATCC
CGCATTTTTAGTCCGTTCC -> GCATTTTTAGTCCGTTCCG
GCATACCCCGCTAAGAAAG -> CATACCCCGCTAAGAAAGG
CGGCTGATCGCGACTGAGC -> GGCTGATCGCGACTGAGCG
GGTTGCCTGCGGTCTCCCG -> GTTGCCTGCGGTCTCCCGT
CGATGGTATTGGGCAGCTG -> GATGGTATTGGGCAGCTGT
GTCCCCTTCGACTAGTGCG -> TCCCCTTCGACTAGTGCGG
AGTTACGGGTGCGAATGTC -> GTTACGGGTGCGAATGTCG
TATAGCAATTGCCATAGTC -> ATAGCAATTGCCATAGTCG
CGCCAGAGCTCAGTTACGG -> GCCAGAGCTCAGTTACGGG
TTATGGTTCGCCAGAGCTC -> TATGGTTCGCCAGAGCTCA
CACGTCATACGTATGTCGT -> ACGTCATACGTATGTCGTT
AACCAATGCTAAGATTAGT -> ACCAATGCTAAGATTAGTT
CTGTGGGTGGGACTTAGGG -> TGTGGGTGGGACTTAGGGC
ACCCTTCCTGTTCCAAGCG -> CCCTTCCTGTTCCAAGCGT
GAAATAAGACTAGGATTTG -> AAATAAGACTAGGATTTGT
TGCTTCGCATGGAACGAAT -> GCTTCGCATGGAACGAATG
GCGACTGAGCGCATACCCC -> CGACTGAGCGCATACCCCG
AAATAAGACTAGGGTTGCT -> AATAAGACTAGGGTTGCTC
TAACCAAAGTAACAGCATA -> AACCAAAGTAACAGCATAA
TTCTGACTGGTCGGATCAA -> TCTGACTGGTCGGATCAAC
GTCGGAGGAGTCCGGGAGA -> TCGGAGGAGTCCGGGAGAT
CATGATCGTATAAATGCAA -> ATGATCGTATAAATGCAAC
AGTTCGGAAATAGGAGTTC -> GTTCGGAAATAGGAGTTCT
TAAGACTAGGTTGCCTGCG -> AAGACTAGGTTGCCTGCGG
CGCAGTGCTCCCGTAGAAA -> GCAGTGCTCCCGTAGAAAC
TAGGTTGCCTGCGGTCTCC -> AGGTTGCCTGCGGTCTCCC
AGCAGTGTATAACCAAAGT -> GCAGTGTATAACCAAAGTA
TTAGTCCGTTCCGTATGAT -> TAGTCCGTTCCGTATGATC
GCCAGACGCTGTTTCTTCC -> CCAGACGCTGTTTCTTCCC
ATTGTGGAACCCTTCCTGT -> TTGTGGAACCCTTCCTGTT
GTCGAAAAGAATTATCCAG -> TCGAAAAGAATTATCCAGG
GTTCCCAGCGTGTTCAAAG -> TTCCCAGCGTGTTCAAAGC
GCTTGGGCCTGCTTGAACA -> CTTGGGCCTGCTTGAACAG
TTTACCATATGCGAAAACA -> TTACCATATGCGAAAACAG
GGAGCATGGACTTCACTTC -> GAGCATGGACTTCACTTCA
GGCAAACCTTCAAAATAAA -> GCAAACCTTCAAAATAAAT
ACAGGTCACAGCACTGTAT -> CAGGTCACAGCACTGTATA
CTATACACCGTGAATAAAC -> TATACACCGTGAATAAACC
ATCTTCCTGTTCCTTATGG -> TCTTCCTGTTCCTTATGGT
AATGAAATAAGACTAGGGT -> ATGAAATAAGACTAGGGTT
GGGCTTAATTTAGCGGCCG -> GGCTTAATTTAGCGGCCGC
TCCGGATGTTGCAGCACTA -> CCGGATGTTGCAGCACTAC
ATGTCTGGCTGCACGTGCT -> TGTCTGGCTGCACGTGCTA
CTGTGATAAACTTCGTCCA -> TGTGATAAACTTCGTCCAA
CAGCACGGCGCATTAATGG -> AGCACGGCGCATTAATGGT
CAGACGGTAAGTGAATGAA -> AGACGGTAAGTGAATGAAA
AACTACGCACGTCCCCTTC -> ACTACGCACGTCCCCTTCG
TATACGACTTCACGGGGAT -> ATACGACTTCACGGGGATC
CCTTCCGTAAGCTAGGAAC -> CTTCCGTAAGCTAGGAACA
GGTTGCTCCGGACTCCCGT -> GTTGCTCCGGACTCCCGTT
GCTCATGTGTCCCTCTCGT -> CTCATGTGTCCCTCTCGTA
GTGGATATGTCAAATTATC -> TGGATATGTCAAATTATCT
CACTGTATAGTAGCTACTC -> ACTGTATAGTAGCTACTCG
TTGCCTGCGGTCTCCCGTT -> TGCCTGCGGTCTCCCGTTC
AACAGCACGGCGCATTAAT -> ACAGCACGGCGCATTAATG
CTGAGAGGTCGGGGGGGTC -> TGAGAGGTCGGGGGGGTCG
GCTTCGCGCACTACCCATT -> CTTCGCGCACTACCCATTA
CCCGTTCTTGTTACATTTG -> CCGTTCTTGTTACATTTGA
GACTCCCGTTCTTGTTACA -> ACTCCCGTTCTTGTTACAT
CCCGTTCTTGTTACATTGA -> CCGTTCTTGTTACATTGAG
TGAAATAAGACTAGGATTT -> GAAATAAGACTAGGATTTG
AATACAGTGTCTATACGGA -> ATACAGTGTCTATACGGAC
GGAGTCCGGGAGATCCTGT -> GAGTCCGGGAGATCCTGTG
CGTGTTCAAAGCGACCGAC -> GTGTTCAAAGCGACCGACA
GTATTGGGCAGCTGTGGGT -> TATTGGGCAGCTGTGGGTG
GGAACGGGCCGCTGAGACC -> GAACGGGCCGCTGAGACCA
GTATATTGGTATACATATA -> TATATTGGTATACATATAC
GCCCCACCGCCGGTGAAGC -> CCCCACCGCCGGTGAAGCC
GGTTGGCAGCGAGAACGTA -> GTTGGCAGCGAGAACGTAT
AAATGCTTCGCATGGAACG -> AATGCTTCGCATGGAACGA
CGGTGGAACGGGCCGCTGA -> GGTGGAACGGGCCGCTGAG
GCATAACAAGACGGCGTAG -> CATAACAAGACGGCGTAGG
TATAGAGTGGACCGCTCCG -> ATAGAGTGGACCGCTCCGG
TAGTAGGCAAACCTTCAAA -> AGTAGGCAAACCTTCAAAA
TGTGGAACCCTTCCTGTTC -> GTGGAACCCTTCCTGTTCC
AGACGGTAAGTGAATGAAA -> GACGGTAAGTGAATGAAAT
TAGGCAAACCTTCAAAATA -> AGGCAAACCTTCAAAATAA
AACAGAAAATTCGGCTTGC -> ACAGAAAATTCGGCTTGCG
TCGGCAGAGATCTATTAGT -> CGGCAGAGATCTATTAGTG
ATGCTTCGCATGGAACGAA -> TGCTTCGCATGGAACGAAT
TACCCCGCTAAGAAAGGTG -> ACCCCGCTAAGAAAGGTGC
TGGAGCAACAGGGTGCACA -> GGAGCAACAGGGTGCACAA
CACTACTATTGGGTGACGG -> ACTACTATTGGGTGACGGT
ATTATCCAGGTAGAGATTG -> TTATCCAGGTAGAGATTGG
AGCTCGCCCTATCATGCAG -> GCTCGCCCTATCATGCAGC
CAATCTTGGGGACAGATTT -> AATCTTGGGGACAGATTTT
TGCCCTGGAACCCTCACTA -> GCCCTGGAACCCTCACTAC
AAGAATATGGTGCATAGCC -> AGAATATGGTGCATAGCCT
TTGGCAAAAATCGATATAA -> TGGCAAAAATCGATATAAT
TTTCTTCCCATTGGAAAAA -> TTCTTCCCATTGGAAAAAC
TTCCGTATGATCCATTAAA -> TCCGTATGATCCATTAAAG
GCAATTAGGGAGACCTAGG -> CAATTAGGGAGACCTAGGT
TATGTCGTTAAACCTTGTC -> ATGTCGTTAAACCTTGTCC
CAGTTTCTGTTGGTAGCTA -> AGTTTCTGTTGGTAGCTAT
ATACTACAGGTCACAGCAC -> TACTACAGGTCACAGCACT
TTCAAAGCGACCGACACGT -> TCAAAGCGACCGACACGTG
GTATTGATGGCTCCGCAGT -> TATTGATGGCTCCGCAGTG
TGTTTCTTCCCATTGGAAA -> GTTTCTTCCCATTGGAAAA
CGTCATTCTGTTAGGTATA -> GTCATTCTGTTAGGTATAC
CAGCATAACAAGACGGCGT -> AGCATAACAAGACGGCGTA
GCCCGTCATTCTGTTAGGT -> CCCGTCATTCTGTTAGGTA
GGAGTGCCGAATGAACCAA -> GAGTGCCGAATGAACCAAT
CCGGATGTTGCAGCACTAC -> CGGATGTTGCAGCACTACT
ATACACCGTGAATAAACCG -> TACACCGTGAATAAACCGG
GCCAGACGGTAAGTGAATG -> CCAGACGGTAAGTGAATGA
AGCGAGAACGTATTGGCAA -> GCGAGAACGTATTGGCAAA
CCGTATGATCCATTAAAGT -> CGTATGATCCATTAAAGTC
AATCGCCAGACGGTAAGTG -> ATCGCCAGACGGTAAGTGA
CATTACGGATAACAAGGTG -> ATTACGGATAACAAGGTGC
ATCCTAATACAGTGTCTAT -> TCCTAATACAGTGTCTATA
GCAACTGGTGCCTTCTTAC -> CAACTGGTGCCTTCTTACG
ATTAGCAGTGTATAACCAA -> TTAGCAGTGTATAACCAAA
AACTACGTGTCTAGACTCG -> ACTACGTGTCTAGACTCGC
AAATAAGACTAGGATTTGT -> AATAAGACTAGGATTTGTG
CCTCAGCTTGCACGGACAC -> CTCAGCTTGCACGGACACG
CTAGAGCCAAGCTTCAGGT -> TAGAGCCAAGCTTCAGGTG
GTCTCCCGTTCTTGTTACA -> TCTCCCGTTCTTGTTACAT
ACTAGGGTTGCTCCGGACT -> CTAGGGTTGCTCCGGACTC
ACCGTGGGTCAGTACAATT -> CCGTGGGTCAGTACAATTG
ACTAGGTTGCCTGCGGTCT -> CTAGGTTGCCTGCGGTCTC
AAGACTAGGTTGCCTGCGG -> AGACTAGGTTGCCTGCGGT
GGCTGATCGCGACTGAGCG -> GCTGATCGCGACTGAGCGC
GGATCAACCTTCCGTAAGC -> GATCAACCTTCCGTAAGCT
CACGTGGTTGGCAGCGAGA -> ACGTGGTTGGCAGCGAGAA
GTAACAGCATAACAAGACG -> TAACAGCATAACAAGACGG
GTCTAGACTCGCAGTTTCT -> TCTAGACTCGCAGTTTCTG
GATGTGTACTGCAATCGGG -> ATGTGTACTGCAATCGGGG
ATTGGGCAGCTGTGGGTGG -> TTGGGCAGCTGTGGGTGGG
GCTCGCCCTATCATGCAGC -> CTCGCCCTATCATGCAGCA
TCGCAGTAGATGGAGTGCC -> CGCAGTAGATGGAGTGCCG
CAATTTGCCCCTCTCCGGG -> AATTTGCCCCTCTCCGGGA
CAGAGATCTATTAGTGCAT -> AGAGATCTATTAGTGCATC
TAAAGTCTATTCTATCCTC -> AAAGTCTATTCTATCCTCG
TTACATTGAGGGCTTAGCA -> TACATTGAGGGCTTAGCAA
AGGAAGTACCACCACCCCA -> GGAAGTACCACCACCCCAA
CATTTTTAGTCCGTTCCGT -> ATTTTTAGTCCGTTCCGTA
GTCCGGGAGATCCTGTGAT -> TCCGGGAGATCCTGTGATA
CAATTTCAATCTTGGGGAC -> AATTTCAATCTTGGGGACA
GCGTGACTCTGGCGGACGG -> CGTGACTCTGGCGGACGGC
CCCTCTCCGGGAATGAAAT -> CCTCTCCGGGAATGAAATA
CCGCAGTGCTCCCGTAGAA -> CGCAGTGCTCCCGTAGAAA
GTTCTTGTTACATTGAGGG -> TTCTTGTTACATTGAGGGC
TTCAAACCACACCCGACAT -> TCAAACCACACCCGACATG
GTGCGTGACTCTGGCGGAC -> TGCGTGACTCTGGCGGACG
GCGGTCTCCCGTTCTTGTT -> CGGTCTCCCGTTCTTGTTA
TGCTTTCGGAACAATCGGC -> GCTTTCGGAACAATCGGCA
GTCCCGCTCATGTGTCCCT -> TCCCGCTCATGTGTCCCTC
CATTGGAAAAACTGATGTT -> ATTGGAAAAACTGATGTTG
ATTAGTGGCATAGGAGATT -> TTAGTGGCATAGGAGATTC
ACATTAGTCAGGTCTGCCA -> CATTAGTCAGGTCTGCCAT
TTCACTTCAAGGAGTTACC -> TCACTTCAAGGAGTTACCA
GCAGTGTATAACCAAAGTA -> CAGTGTATAACCAAAGTAA
TATATTGGTATACATATAC -> ATATTGGTATACATATACC
AGGTGCCCGTCATTCTGTT -> GGTGCCCGTCATTCTGTTA
AGGAACACCAACAATTTGC -> GGAACACCAACAATTTGCC
GCCAACGTGACGCATTTTT -> CCAACGTGACGCATTTTTA
TCGGAGGAGTCCGGGAGAT -> CGGAGGAGTCCGGGAGATC
TGGGCTGTATTGATGGCTC -> GGGCTGTATTGATGGCTCC
CCAGAGCTCAGTTACGGGT -> CAGAGCTCAGTTACGGGTG
GCTACTCGCAGTAGATGGA -> CTACTCGCAGTAGATGGAG
CATAGCCTGTGAGCTGTGC -> ATAGCCTGTGAGCTGTGCC
CTGCACGTGCTATACACCG -> TGCACGTGCTATACACCGT
TCAGGTCTGCCATTTACCA -> CAGGTCTGCCATTTACCAT
ATAGCATGAGGTCAGTCGT -> TAGCATGAGGTCAGTCGTA
CACTCCCGTTCTTGTTACA -> ACTCCCGTTCTTGTTACAT
TTGGTCGAAAAGAATTATC -> TGGTCGAAAAGAATTATCC
TAAATGCAACAAGTAGGTG -> AAATGCAACAAGTAGGTGG
GGATAACAAGGTGCCCGTC -> GATAACAAGGTGCCCGTCA
CAGCAACTGGTGCCTTCTT -> AGCAACTGGTGCCTTCTTA
CGGTATAGCAATTGCCATA -> GGTATAGCAATTGCCATAG
TCACTTCAAGGAGTTACCA -> CACTTCAAGGAGTTACCAT
CGCGACCCAACTACGCACG -> GCGACCCAACTACGCACGT
CTGTGAGCTGTGCCCTGGA -> TGTGAGCTGTGCCCTGGAA
GTGACTCTGGCGGACGGCT -> TGACTCTGGCGGACGGCTA
TTCCTGTTCCAAGCGTGTG -> TCCTGTTCCAAGCGTGTGG
CGCTCCGGATGTTGCAGCA -> GCTCCGGATGTTGCAGCAC
AGAAAGGTGCGTGACTCTG -> GAAAGGTGCGTGACTCTGG
GAGATTCACATGTCTGGCT -> AGATTCACATGTCTGGCTG
TGTTACATTAGTGGCATAG -> GTTACATTAGTGGCATAGG
CTCGTAGCGGTCTCGATGG -> TCGTAGCGGTCTCGATGGA
AAGATCTAGAGCCAAGCTT -> AGATCTAGAGCCAAGCTTC
CCCAGCGTGTTCAAAGCGA -> CCAGCGTGTTCAAAGCGAC
TGGTGCATAGCCTGTGAGC -> GGTGCATAGCCTGTGAGCT
TTCAAGGAGTTACCATAAA -> TCAAGGAGTTACCATAAAG
CCCCTTCGACTAGTGCGGT -> CCCTTCGACTAGTGCGGTG
GGCTGTATTGATGGCTCCG -> GCTGTATTGATGGCTCCGC
ATGCTAAGATTAGTTCGGA -> TGCTAAGATTAGTTCGGAA
TTCGCGACCCAACTACGCA -> TCGCGACCCAACTACGCAC
TTTCTGTTGGTAGCTATAG -> TTCTGTTGGTAGCTATAGA
CTGGCTGCACGTGCTATAC -> TGGCTGCACGTGCTATACA
GTTAAACCTTGTCCTTCTG -> TTAAACCTTGTCCTTCTGT
TCGTTTTGTCGGAGGAGTC -> CGTTTTGTCGGAGGAGTCC
GTTTCTGACTGGTCGGATC -> TTTCTGACTGGTCGGATCA
CCCATTACGGATAACAAGG -> CCATTACGGATAACAAGGT
GTTCCAAGCGTGTGGAGAG -> TTCCAAGCGTGTGGAGAGC
ATAACCAAAGTAACAGCAT -> TAACCAAAGTAACAGCATA
TCCGTTCCGTATGATCCAT -> CCGTTCCGTATGATCCATT
CCCCGCTAAGAAAGGTGCG -> CCCGCTAAGAAAGGTGCGT
CAAGCGTGTGGAGAGCCTA -> AAGCGTGTGGAGAGCCTAG
TTTGGTCGAAAAGAATTAT -> TTGGTCGAAAAGAATTATC
TCATGTGTCCCTCTCGTAT -> CATGTGTCCCTCTCGTATA
CGTGCTATACACCGTGAAT -> GTGCTATACACCGTGAATA
ACATATACCGTGGGTCAGT -> CATATACCGTGGGTCAGTA
TGGAACGAATGAAATAAGA -> GGAACGAATGAAATAAGAC
CCCTCTCGTATATTGGTAT -> CCTCTCGTATATTGGTATA
GAAATAAGACTAGGTTGCC -> AAATAAGACTAGGTTGCCT
AGTCAAGATCTAGAGCCAA -> GTCAAGATCTAGAGCCAAG
CTCGCCCTATCATGCAGCA -> TCGCCCTATCATGCAGCAT
GCCGCTGAGACCAGAATGA -> CCGCTGAGACCAGAATGAA
CCTCTGCGCAGATTGCTTT -> CTCTGCGCAGATTGCTTTC
CCGCCGGTGAAGCCAGGAA -> CGCCGGTGAAGCCAGGAAG
TTCTTCCCATTGGAAAAAC -> TCTTCCCATTGGAAAAACT
AATAAATCAGCAACTGGTG -> ATAAATCAGCAACTGGTGC
CTAGGCGGTGCCCGCACTC -> TAGGCGGTGCCCGCACTCC
CTGCATTGTGGAACCCTTC -> TGCATTGTGGAACCCTTCC
GTGATTCGTCCTACATCCT -> TGATTCGTCCTACATCCTA
ACGGTAAGTGAATGAAATA -> CGGTAAGTGAATGAAATAA
ATCTGCATTGTGGAACCCT -> TCTGCATTGTGGAACCCTT
GAAACTACGTGTCTAGACT -> AAACTACGTGTCTAGACTC
GCTTTCGGAACAATCGGCA -> CTTTCGGAACAATCGGCAG
TGGTTGGCAGCGAGAACGT -> GGTTGGCAGCGAGAACGTA
TCGAATTAGCAGTGTATAA -> CGAATTAGCAGTGTATAAC
TAAACTTCGTCCAAAAAGG -> AAACTTCGTCCAAAAAGGG
AGGTCAGTCGTACCGTGCC -> GGTCAGTCGTACCGTGCCT
CGCCAACGTGACGCATTTT -> GCCAACGTGACGCATTTTT
TGCTCCGGACTCCCGTTCT -> GCTCCGGACTCCCGTTCTT
TCCCCTTCGACTAGTGCGG -> CCCCTTCGACTAGTGCGGT
GTTCCTTATGGTTCGCCAG -> TTCCTTATGGTTCGCCAGA
GTGGAACCCTTCCTGTTCC -> TGGAACCCTTCCTGTTCCA
AAACAGAAAATTCGGCTTG -> AACAGAAAATTCGGCTTGC
GCGAGAACGTATTGGCAAA -> CGAGAACGTATTGGCAAAA
CTTTCGGAACAATCGGCAG -> TTTCGGAACAATCGGCAGA
AGACTAGGGTTGCTCCGGA -> GACTAGGGTTGCTCCGGAC
TACGGACAATCTAATATCG -> ACGGACAATCTAATATCGA
AACCAAAGTAACAGCATAA -> ACCAAAGTAACAGCATAAC
ACCGCTCCGGATGTTGCAG -> CCGCTCCGGATGTTGCAGC
GAAATGCTTCGCATGGAAC -> AAATGCTTCGCATGGAACG
TTGCCCCTCTCCGGGAATG -> TGCCCCTCTCCGGGAATGA
AGAGATTGGAGCATGGACT -> GAGATTGGAGCATGGACTT
TTCTTACGAAAAAATCATG -> TCTTACGAAAAAATCATGA
GTCCGTTCCGTATGATCCA -> TCCGTTCCGTATGATCCAT
CACCACCCCAAGCTCGCCC -> ACCACCCCAAGCTCGCCCT
GTATAGTAGCTACTCGCAG -> TATAGTAGCTACTCGCAGT
TAGGGAATTGTGAAATGCT -> AGGGAATTGTGAAATGCTT
TGCACGAAGTCAAGATCTA -> GCACGAAGTCAAGATCTAG
GAGGTCAGTCGTACCGTGC -> AGGTCAGTCGTACCGTGCC
TAATACTACAGGTCACAGC -> AATACTACAGGTCACAGCA
GGTATACGACTTCACGGGG -> GTATACGACTTCACGGGGA
CGATATAATACTACAGGTC -> GATATAATACTACAGGTCA
GATTGCTTTCGGAACAATC -> ATTGCTTTCGGAACAATCG
CTCAGTTACGGGTGCGAAT -> TCAGTTACGGGTGCGAATG
TATAGTAGCTACTCGCAGT -> ATAGTAGCTACTCGCAGTA
GGACAGATTTTGGTCGAAA -> GACAGATTTTGGTCGAAAA
GATCTCATCACCTCAGCTT -> ATCTCATCACCTCAGCTTG
GTCGAATTAGCAGTGTATA -> TCGAATTAGCAGTGTATAA
TAGGGCTCGTAGCGGTCTC -> AGGGCTCGTAGCGGTCTCG
ATTTGTGCGGCCTCCCGTT -> TTTGTGCGGCCTCCCGTTC
GAACGAATGAAATAAGACT -> AACGAATGAAATAAGACTA
ATTTCAATCTTGGGGACAG -> TTTCAATCTTGGGGACAGA
TTGGGCTGTATTGATGGCT -> TGGGCTGTATTGATGGCTC
CCGCTGAGACCAGAATGAA -> CGCTGAGACCAGAATGAAA
GAAATAGGAGTTCTGAGAG -> AAATAGGAGTTCTGAGAGG
ACAAGACGGCGTAGGGAAT -> CAAGACGGCGTAGGGAATT
CTAGGTTGCCTGCGGTCTC -> TAGGTTGCCTGCGGTCTCC
GTTCTTGTTACATTAGTGG -> TTCTTGTTACATTAGTGGC
AAATCGATATAATACTACA -> AATCGATATAATACTACAG
TGGAGTGCCGAATGAACCA -> GGAGTGCCGAATGAACCAA
GGTAGCTATAGAGTGGACC -> GTAGCTATAGAGTGGACCG
ACGGACAATCTAATATCGA -> CGGACAATCTAATATCGAT
GCCTGTGAGCTGTGCCCTG -> CCTGTGAGCTGTGCCCTGG
CATGTGTCCCTCTCGTATA -> ATGTGTCCCTCTCGTATAT
AAAAGGGGCTGTAGTAGGC -> AAAGGGGCTGTAGTAGGCA
TATCATGCAGCATCTCCCC -> ATCATGCAGCATCTCCCCT
GTTCCGTATGATCCATTAA -> TTCCGTATGATCCATTAAA
ACGGCGCATTAATGGTCGC -> CGGCGCATTAATGGTCGCC
CGTTAAACCTTGTCCTTCT -> GTTAAACCTTGTCCTTCTG
CTAGGGTTGCTCCGGACTC -> TAGGGTTGCTCCGGACTCC
ACGACTTCACGGGGATCCT -> CGACTTCACGGGGATCCTA
TCTAGACTCGCAGTTTCTG -> CTAGACTCGCAGTTTCTGT
GCTTAGCAACCATCTTGCC -> CTTAGCAACCATCTTGCCC
GTATTGGCAAAAATCGATA -> TATTGGCAAAAATCGATAT
CAGGAAGTACCACCACCCC -> AGGAAGTACCACCACCCCA
CCCTCACTACAACATTAGC -> CCTCACTACAACATTAGCT
AACAATCGGCAGAGATCTA -> ACAATCGGCAGAGATCTAT
GGCGCATTAATGGTCGCCT -> GCGCATTAATGGTCGCCTC
TCTGGCGGACGGCTAAATC -> CTGGCGGACGGCTAAATCG
GTGTACTGCAATCGGGGGG -> TGTACTGCAATCGGGGGGC
ACAAGTAGGTGGATATGTC -> CAAGTAGGTGGATATGTCA
TGGCGGACGGCTAAATCGC -> GGCGGACGGCTAAATCGCC
AAGTCTATTCTATCCTCGT -> AGTCTATTCTATCCTCGTT
CGACACGTGGTTGGCAGCG -> GACACGTGGTTGGCAGCGA
CCATAGTCGGTGATTCGTC -> CATAGTCGGTGATTCGTCC
AGATTCACATGTCTGGCTG -> GATTCACATGTCTGGCTGC
ATAAGACTAGGCGGTGCCC -> TAAGACTAGGCGGTGCCCG
GGATATGTCAAATTATCTG -> GATATGTCAAATTATCTGC
TTGGCAGCGAGAACGTATT -> TGGCAGCGAGAACGTATTG
CGAAAAAATCATGATCGTA -> GAAAAAATCATGATCGTAT
TGCCCCTCTCCGGGAATGA -> GCCCCTCTCCGGGAATGAA
TTTTAGTCCGTTCCGTATG -> TTTAGTCCGTTCCGTATGA
AAACCGGCTGATCGCGACT -> AACCGGCTGATCGCGACTG
GTGACGGTTCATCTACGAT -> TGACGGTTCATCTACGATC
GAGGTCGGGGGGGTCGTGC -> AGGTCGGGGGGGTCGTGCA
AACCTTCAAAATAAATCAG -> ACCTTCAAAATAAATCAGC
CCGGGGGGGAACGCAATTA -> CGGGGGGGAACGCAATTAG
TGAGAGGTCGGGGGGGTCG -> GAGAGGTCGGGGGGGTCGT
GCGGCCTCCCGTTCTTGTT -> CGGCCTCCCGTTCTTGTTA
TCATACGTATGTCGTTAAA -> CATACGTATGTCGTTAAAC
GGCAGCGAGAACGTATTGG -> GCAGCGAGAACGTATTGGC
GGCTAAATCGCCAGACGGT -> GCTAAATCGCCAGACGGTA
TGTCGTAAACAGCACGGCG -> GTCGTAAACAGCACGGCGC
CCGACACGTGGTTGGCAGC -> CGACACGTGGTTGGCAGCG
GCAGTGCTCCCGTAGAAAC -> CAGTGCTCCCGTAGAAACT
GATCCATTAAAGTCTATTC -> ATCCATTAAAGTCTATTCT
ACAATCTAATATCGATCCA -> CAATCTAATATCGATCCAT
TGTCGGGTGAAGCGAAGAA -> GTCGGGTGAAGCGAAGAAT
CTAATACAGTGTCTATACG -> TAATACAGTGTCTATACGG
CTAAGATTAGTTCGGAAAT -> TAAGATTAGTTCGGAAATA
GCACGAAGTCAAGATCTAG -> CACGAAGTCAAGATCTAGA
ACGTGGTTGGCAGCGAGAA -> CGTGGTTGGCAGCGAGAAC
GCCAGAGCTCAGTTACGGG -> CCAGAGCTCAGTTACGGGT
CAACAAGTAGGTGGATATG -> AACAAGTAGGTGGATATGT
AAGCCAGGAAGTACCACCA -> AGCCAGGAAGTACCACCAC
AGTGTCTATACGGACAATC -> GTGTCTATACGGACAATCT
TAAGACTAGGGTTGCTCCG -> AAGACTAGGGTTGCTCCGG
AGCATCTCCCCTTCTCCGT -> GCATCTCCCCTTCTCCGTT
TTCGTCCTACATCCTAATA -> TCGTCCTACATCCTAATAC
CAAGATCTAGAGCCAAGCT -> AAGATCTAGAGCCAAGCTT
GGAACCCTCACTACAACAT -> GAACCCTCACTACAACATT
ATAAACTTCGTCCAAAAAG -> TAAACTTCGTCCAAAAAGG
CCGGTATAGCAATTGCCAT -> CGGTATAGCAATTGCCATA
CTGCTTGAACAGTCACAAA -> TGCTTGAACAGTCACAAAC
AGGGTGCACAAACCGGGGG -> GGGTGCACAAACCGGGGGG
TTGTTACATTAGTCAGGTC -> TGTTACATTAGTCAGGTCT
CCAAGCGTGTGGAGAGCCT -> CAAGCGTGTGGAGAGCCTA
CACAAACCGGGGGGGAACG -> ACAAACCGGGGGGGAACGC
GGGGGAACGCAATTAGGGA -> GGGGAACGCAATTAGGGAG
CCCATTGGAAAAACTGATG -> CCATTGGAAAAACTGATGT
GCATTTTTAGTCCGTTCCG -> CATTTTTAGTCCGTTCCGT
TCACGGGGATCCTATCACC -> CACGGGGATCCTATCACCG
TATCACCGGTATAGCAATT -> ATCACCGGTATAGCAATTG
TAGGGTTGCTCCGGACTCC -> AGGGTTGCTCCGGACTCCC
GCACTGTATAGTAGCTACT -> CACTGTATAGTAGCTACTC
CATCAGGATTATGTTTATT -> ATCAGGATTATGTTTATTA
GTGAAATGCTTCGCATGGA -> TGAAATGCTTCGCATGGAA
TGTCCTTCTGTCGTAAACA -> GTCCTTCTGTCGTAAACAG
TACTGCAATCGGGGGGCTT -> ACTGCAATCGGGGGGCTTC
GATGGTATTGGGCAGCTGT -> ATGGTATTGGGCAGCTGTG
AGATTAGTTCGGAAATAGG -> GATTAGTTCGGAAATAGGA
CGGAGGAGTCCGGGAGATC -> GGAGGAGTCCGGGAGATCC
CATCCTAATACAGTGTCTA -> ATCCTAATACAGTGTCTAT
TCTGTTAGGTATACGACTT -> CTGTTAGGTATACGACTTC
CTAGACTCGCAGTTTCTGT -> TAGACTCGCAGTTTCTGTT
AGCTTCAGGTGACAATGTC -> GCTTCAGGTGACAATGTCC
AGAATATGGTGCATAGCCT -> GAATATGGTGCATAGCCTG
GCGTAGGGAATTGTGAAAT -> CGTAGGGAATTGTGAAATG
GCCGGTGAAGCCAGGAAGT -> CCGGTGAAGCCAGGAAGTA
GCTGTAGTAGGCAAACCTT -> CTGTAGTAGGCAAACCTTC
ACATTTGATGTGTACTGCA -> CATTTGATGTGTACTGCAA
TAAGCTAGGAACACCAACA -> AAGCTAGGAACACCAACAA
TTGTGGAACCCTTCCTGTT -> TGTGGAACCCTTCCTGTTC
ACCGTGAATAAACCGGCTG -> CCGTGAATAAACCGGCTGA
TCTAATATCGATCCATGAC -> CTAATATCGATCCATGACT
AAAAATCATGATCGTATAA -> AAAATCATGATCGTATAAA
CTTGGGCCTGCTTGAACAG -> TTGGGCCTGCTTGAACAGT
AGAGATCTATTAGTGCATC -> GAGATCTATTAGTGCATCA
GCTCCGGACTCCCGTTCTT -> CTCCGGACTCCCGTTCTTG
CGGTGATTCGTCCTACATC -> GGTGATTCGTCCTACATCC
GGCGGTGCCCGCACTCCCG -> GCGGTGCCCGCACTCCCGT
ATTCGTCCTACATCCTAAT -> TTCGTCCTACATCCTAATA
ACAGAAAATTCGGCTTGCG -> CAGAAAATTCGGCTTGCGT
GCATCAGGATTATGTTTAT -> CATCAGGATTATGTTTATT
AAACCTTCAAAATAAATCA -> AACCTTCAAAATAAATCAG
GATGGAGTGCCGAATGAAC -> ATGGAGTGCCGAATGAACC
GAGAGCCTAGCCAGACGCT -> AGAGCCTAGCCAGACGCTG
GGACCGCTCCGGATGTTGC -> GACCGCTCCGGATGTTGCA
CATGAGGTCAGTCGTACCG -> ATGAGGTCAGTCGTACCGT
TAGTGCATCAGGATTATGT -> AGTGCATCAGGATTATGTT
AATTATCCAGGTAGAGATT -> ATTATCCAGGTAGAGATTG
TTTAGCGGCCGCCAACGTG -> TTAGCGGCCGCCAACGTGA
ATTAGCTTGGGCCTGCTTG -> TTAGCTTGGGCCTGCTTGA
TGTGCAATTTCAATCTTGG -> GTGCAATTTCAATCTTGGG
AATGAAATAAGACTAGGTT -> ATGAAATAAGACTAGGTTG
TCTTGTTACATTAGTCAGG -> CTTGTTACATTAGTCAGGT
GCAGATTGCTTTCGGAACA -> CAGATTGCTTTCGGAACAA
CTCCGGGAATGAAATAAGA -> TCCGGGAATGAAATAAGAC
TTAGCGGCCGCCAACGTGA -> TAGCGGCCGCCAACGTGAC
GGTGCATAGCCTGTGAGCT -> GTGCATAGCCTGTGAGCTG
GGGAGACCTAGGTGGTATG -> GGAGACCTAGGTGGTATGT
CGTTCTTGTTACATTAGTC -> GTTCTTGTTACATTAGTCA
GTGCTCCCGTAGAAACTAC -> TGCTCCCGTAGAAACTACG
GCAACAAGTAGGTGGATAT -> CAACAAGTAGGTGGATATG
TAGCCTGTGAGCTGTGCCC -> AGCCTGTGAGCTGTGCCCT
GTGTATAACCAAAGTAACA -> TGTATAACCAAAGTAACAG
CAATCGGGGGGCTTCGCGC -> AATCGGGGGGCTTCGCGCA
TTAGGGCTCGTAGCGGTCT -> TAGGGCTCGTAGCGGTCTC
GTGCCTTCTTACGAAAAAA -> TGCCTTCTTACGAAAAAAT
CACATGTCTGGCTGCACGT -> ACATGTCTGGCTGCACGTG
TTGGGTGACGGTTCATCTA -> TGGGTGACGGTTCATCTAC
GGTGACAATGTCCCGCTCA -> GTGACAATGTCCCGCTCAT
TTTCAATCTTGGGGACAGA -> TTCAATCTTGGGGACAGAT
GTGGACCGCTCCGGATGTT -> TGGACCGCTCCGGATGTTG
TACACCGTGAATAAACCGG -> ACACCGTGAATAAACCGGC
TCGGGGGGCTTCGCGCACT -> CGGGGGGCTTCGCGCACTA
TAGTCGGTGATTCGTCCTA -> AGTCGGTGATTCGTCCTAC
ACTCCCGTTCTTGTTACAT -> CTCCCGTTCTTGTTACATT,CTCCCGTTCTTGTTACATT
CAAACCGGGGGGGAACGCA -> AAACCGGGGGGGAACGCAA
ATGACTGTGCAATTTCAAT -> TGACTGTGCAATTTCAATC
ACCGGGGGGGAACGCAATT -> CCGGGGGGGAACGCAATTA
TGGTCGAATTAGCAGTGTA -> GGTCGAATTAGCAGTGTAT
CCATTGGAAAAACTGATGT -> CATTGGAAAAACTGATGTT
CTCCGCAGTGCTCCCGTAG -> TCCGCAGTGCTCCCGTAGA
GGGCAGCTGTGGGTGGGAC -> GGCAGCTGTGGGTGGGACT
TATAAATGCAACAAGTAGG -> ATAAATGCAACAAGTAGGT
CCAATGCTAAGATTAGTTC -> CAATGCTAAGATTAGTTCG
CTCATCACCTCAGCTTGCA -> TCATCACCTCAGCTTGCAC
CCAAAAAGGGGCTGTAGTA -> CAAAAAGGGGCTGTAGTAG
ACGCATTTTTAGTCCGTTC -> CGCATTTTTAGTCCGTTCC
TCCTGTTCCAAGCGTGTGG -> CCTGTTCCAAGCGTGTGGA
GAGCATGGACTTCACTTCA -> AGCATGGACTTCACTTCAA
TTGAACAGTCACAAACGAA -> TGAACAGTCACAAACGAAT
CGATGGAGCAACAGGGTGC -> GATGGAGCAACAGGGTGCA
TCAAAATAAATCAGCAACT -> CAAAATAAATCAGCAACTG
ACAAACCGGGGGGGAACGC -> CAAACCGGGGGGGAACGCA
TATGGTTCGCCAGAGCTCA -> ATGGTTCGCCAGAGCTCAG
GAGTGCCGAATGAACCAAT -> AGTGCCGAATGAACCAATG
CATCTCCCCTTCTCCGTTC -> ATCTCCCCTTCTCCGTTCA
ATTAGTCAGGTCTGCCATT -> TTAGTCAGGTCTGCCATTT
CTGACGATGGTATTGGGCA -> TGACGATGGTATTGGGCAG
GTACAATTGGGCTGTATTG -> TACAATTGGGCTGTATTGA
TATAATACTACAGGTCACA -> ATAATACTACAGGTCACAG
TTCATACATGGCTCTGACG -> TCATACATGGCTCTGACGA
GCGTGTGGAGAGCCTAGCC -> CGTGTGGAGAGCCTAGCCA
GCGCACTACCCATTACGGA -> CGCACTACCCATTACGGAT
TGTGCGGCCTCCCGTTCTT -> GTGCGGCCTCCCGTTCTTG
TCCCGTTCTTGTTACATTA -> CCCGTTCTTGTTACATTAG,CCCGTTCTTGTTACATTAG
TTGTTACATTAGTGGCATA -> TGTTACATTAGTGGCATAG
TGGGTGGGACTTAGGGCTC -> GGGTGGGACTTAGGGCTCG
AGCGGTCTCGATGGAGCAA -> GCGGTCTCGATGGAGCAAC
AATCGGGGGGCTTCGCGCA -> ATCGGGGGGCTTCGCGCAC
TAATACAGTGTCTATACGG -> AATACAGTGTCTATACGGA
GATGTTGCAGCACTACTAT -> ATGTTGCAGCACTACTATT
GACTCGCAGTTTCTGTTGG -> ACTCGCAGTTTCTGTTGGT
GTTACATTAGTGGCATAGG -> TTACATTAGTGGCATAGGA
CTTCAAAATAAATCAGCAA -> TTCAAAATAAATCAGCAAC
TGCGTGACTCTGGCGGACG -> GCGTGACTCTGGCGGACGG
TGTCGGAGGAGTCCGGGAG -> GTCGGAGGAGTCCGGGAGA
CTTGTTACATTGAGGGCTT -> TTGTTACATTGAGGGCTTA
TGATCCATTAAAGTCTATT -> GATCCATTAAAGTCTATTC
GTATGTGGCGTGTTCCCAG -> TATGTGGCGTGTTCCCAGC
GGCAGAGATCTATTAGTGC -> GCAGAGATCTATTAGTGCA
GCAGCACTACTATTGGGTG -> CAGCACTACTATTGGGTGA
CTTATGGTTCGCCAGAGCT -> TTATGGTTCGCCAGAGCTC
CCATCTTGCCCCACCGCCG -> CATCTTGCCCCACCGCCGG
AAACTGATGTTGTCACGCG -> AACTGATGTTGTCACGCGG
CCCGCACTCCCGTTCTTGT -> CCGCACTCCCGTTCTTGTT
GATCGCGACTGAGCGCATA -> ATCGCGACTGAGCGCATAC
AAATAGGAGTTCTGAGAGG -> AATAGGAGTTCTGAGAGGT
TGAGACCAGAATGAAATAA -> GAGACCAGAATGAAATAAG
AAAGCGACCGACACGTGGT -> AAGCGACCGACACGTGGTT
AATGTCCCGCTCATGTGTC -> ATGTCCCGCTCATGTGTCC
CATTTGATGTGTACTGCAA -> ATTTGATGTGTACTGCAAT
TAGTAGCTACTCGCAGTAG -> AGTAGCTACTCGCAGTAGA
TGCCCGCACTCCCGTTCTT -> GCCCGCACTCCCGTTCTTG
TTGCAGCACTACTATTGGG -> TGCAGCACTACTATTGGGT
CTAAATCGCCAGACGGTAA -> TAAATCGCCAGACGGTAAG
GTTTTGTCGGAGGAGTCCG -> TTTTGTCGGAGGAGTCCGG
AGCTCAGTTACGGGTGCGA -> GCTCAGTTACGGGTGCGAA
GGGGCTGTAGTAGGCAAAC -> GGGCTGTAGTAGGCAAACC
ATCTAATATCGATCCATGA -> TCTAATATCGATCCATGAC
GCATTGTGGAACCCTTCCT -> CATTGTGGAACCCTTCCTG
GGAGATCCTGTGATAAACT -> GAGATCCTGTGATAAACTT
GTGAAGCCAGGAAGTACCA -> TGAAGCCAGGAAGTACCAC
TGCACGTGCTATACACCGT -> GCACGTGCTATACACCGTG
CTCCGGACTCCCGTTCTTG -> TCCGGACTCCCGTTCTTGT
AAGACTAGGATTTGTGCGG -> AGACTAGGATTTGTGCGGC
TAGCGGTCTCGATGGAGCA -> AGCGGTCTCGATGGAGCAA
ATATCGATCCATGACTGTG -> TATCGATCCATGACTGTGC
CAACAGGGTGCACAAACCG -> AACAGGGTGCACAAACCGG
ACATGTCTGGCTGCACGTG -> CATGTCTGGCTGCACGTGC
TACCATATGCGAAAACAGA -> ACCATATGCGAAAACAGAA
GTTCTTCTGGTCGAATTAG -> TTCTTCTGGTCGAATTAGC
AGCGTGTTCAAAGCGACCG -> GCGTGTTCAAAGCGACCGA
CGTATGTCGTTAAACCTTG -> GTATGTCGTTAAACCTTGT
AAAAAGGGGCTGTAGTAGG -> AAAAGGGGCTGTAGTAGGC
GAACACCAACAATTTGCCC -> AACACCAACAATTTGCCCC
ATAAGACTAGGGTTGCTCC -> TAAGACTAGGGTTGCTCCG
CGGTCTCCCGTTCTTGTTA -> GGTCTCCCGTTCTTGTTAC
TCTCCGTTCAAACCACACC -> CTCCGTTCAAACCACACCC
CAACTACGCACGTCCCCTT -> AACTACGCACGTCCCCTTC
CCGGGAATGAAATAAGACT -> CGGGAATGAAATAAGACTA
CGCAGTAGATGGAGTGCCG -> GCAGTAGATGGAGTGCCGA
CAAATTATCTGCATTGTGG -> AAATTATCTGCATTGTGGA
AGAGTGGACCGCTCCGGAT -> GAGTGGACCGCTCCGGATG
ACTGGTGCCTTCTTACGAA -> CTGGTGCCTTCTTACGAAA
TAGGTGGATATGTCAAATT -> AGGTGGATATGTCAAATTA
GGCCGCCAACGTGACGCAT -> GCCGCCAACGTGACGCATT
ACGGCTAAATCGCCAGACG -> CGGCTAAATCGCCAGACGG
TGTTGCAGCACTACTATTG -> GTTGCAGCACTACTATTGG
TTCTTCTGGTCGAATTAGC -> TCTTCTGGTCGAATTAGCA
AGGAGTTACCATAAAGTTC -> GGAGTTACCATAAAGTTCT
TCGCCAGAGCTCAGTTACG -> CGCCAGAGCTCAGTTACGG
CATACGTATGTCGTTAAAC -> ATACGTATGTCGTTAAACC
GACGCATTTTTAGTCCGTT -> ACGCATTTTTAGTCCGTTC
CCGTTCAAACCACACCCGA -> CGTTCAAACCACACCCGAC
GATTTGTGCGGCCTCCCGT -> ATTTGTGCGGCCTCCCGTT
ATGGTCGCCTCTGCGCAGA -> TGGTCGCCTCTGCGCAGAT
CTGATGTTGTCACGCGGAC -> TGATGTTGTCACGCGGACG
ATGCGAAAACAGAAAATTC -> TGCGAAAACAGAAAATTCG
GATTCGTCCTACATCCTAA -> ATTCGTCCTACATCCTAAT
GTGTTCCCAGCGTGTTCAA -> TGTTCCCAGCGTGTTCAAA
CTTAGCAACCATCTTGCCC -> TTAGCAACCATCTTGCCCC
TATCCAGGTAGAGATTGGA -> ATCCAGGTAGAGATTGGAG
TAGTGCGGTGGAACGGGCC -> AGTGCGGTGGAACGGGCCG
CGTAGGGAATTGTGAAATG -> GTAGGGAATTGTGAAATGC
CACCGGTATAGCAATTGCC -> ACCGGTATAGCAATTGCCA
TGACTGGTCGGATCAACCT -> GACTGGTCGGATCAACCTT
CCTCCCGTTCTTGTTACAT -> CTCCCGTTCTTGTTACATT
AGGCGGTGCCCGCACTCCC -> GGCGGTGCCCGCACTCCCG
TAGAAACTACGTGTCTAGA -> AGAAACTACGTGTCTAGAC
TGACTCTGGCGGACGGCTA -> GACTCTGGCGGACGGCTAA
TGATCGTATAAATGCAACA -> GATCGTATAAATGCAACAA
TGCAATTTCAATCTTGGGG -> GCAATTTCAATCTTGGGGA
TTAGTGGCATAGGAGATTC -> TAGTGGCATAGGAGATTCA
CAAGCTCGCCCTATCATGC -> AAGCTCGCCCTATCATGCA
ATAGTAGCTACTCGCAGTA -> TAGTAGCTACTCGCAGTAG
TCAACCTTCCGTAAGCTAG -> CAACCTTCCGTAAGCTAGG
GACTAGGCGGTGCCCGCAC -> ACTAGGCGGTGCCCGCACT
TGAGGGCTTAGCAACCATC -> GAGGGCTTAGCAACCATCT
CGTTCTTGTTACATTGAGG -> GTTCTTGTTACATTGAGGG
AAGGTGCCCGTCATTCTGT -> AGGTGCCCGTCATTCTGTT
ACGCAATTAGGGAGACCTA -> CGCAATTAGGGAGACCTAG
ACCATAAAGTTCTTCTGGT -> CCATAAAGTTCTTCTGGTC
TCCGGGAATGAAATAAGAC -> CCGGGAATGAAATAAGACT
TGTGTACTGCAATCGGGGG -> GTGTACTGCAATCGGGGGG
AAGATTAGTTCGGAAATAG -> AGATTAGTTCGGAAATAGG
GCGTGTTCCCAGCGTGTTC -> CGTGTTCCCAGCGTGTTCA
CGGGGGGGAACGCAATTAG -> GGGGGGGAACGCAATTAGG
TTCGCGCACTACCCATTAC -> TCGCGCACTACCCATTACG
CTTCGCATGGAACGAATGA -> TTCGCATGGAACGAATGAA
TAAACAGCACGGCGCATTA -> AAACAGCACGGCGCATTAA
GCATTAATGGTCGCCTCTG -> CATTAATGGTCGCCTCTGC
ATTAGGGAGACCTAGGTGG -> TTAGGGAGACCTAGGTGGT
ACCGACACGTGGTTGGCAG -> CCGACACGTGGTTGGCAGC
GCGGACGGATCTCATCACC -> CGGACGGATCTCATCACCT
TATCTGCATTGTGGAACCC -> ATCTGCATTGTGGAACCCT
GTATGTCGTTAAACCTTGT -> TATGTCGTTAAACCTTGTC
AATTTCAATCTTGGGGACA -> ATTTCAATCTTGGGGACAG
TTGGGGACAGATTTTGGTC -> TGGGGACAGATTTTGGTCG
TGTTCAAAGCGACCGACAC -> GTTCAAAGCGACCGACACG
AGACCTAGGTGGTATGTGG -> GACCTAGGTGGTATGTGGC
AACAAGGTGCCCGTCATTC -> ACAAGGTGCCCGTCATTCT
TGCACAAACCGGGGGGGAA -> GCACAAACCGGGGGGGAAC
ATTGTGAAATGCTTCGCAT -> TTGTGAAATGCTTCGCATG
CGAAAACAGAAAATTCGGC -> GAAAACAGAAAATTCGGCT
CCAACTACGCACGTCCCCT -> CAACTACGCACGTCCCCTT
CGTGTCTAGACTCGCAGTT -> GTGTCTAGACTCGCAGTTT
CTCCGTTCAAACCACACCC -> TCCGTTCAAACCACACCCG
TGAAATGCTTCGCATGGAA -> GAAATGCTTCGCATGGAAC
GATCTATTAGTGCATCAGG -> ATCTATTAGTGCATCAGGA
GTTCATCTACGATCTTCCT -> TTCATCTACGATCTTCCTG
GCGAAAACAGAAAATTCGG -> CGAAAACAGAAAATTCGGC
AGCCAGGAAGTACCACCAC -> GCCAGGAAGTACCACCACC
ATAGCAATTGCCATAGTCG -> TAGCAATTGCCATAGTCGG
TAGCTATAGAGTGGACCGC -> AGCTATAGAGTGGACCGCT
CGGGAATGAAATAAGACTA -> GGGAATGAAATAAGACTAG
CATGGCTCTGACGATGGTA -> ATGGCTCTGACGATGGTAT
TACGGATAACAAGGTGCCC -> ACGGATAACAAGGTGCCCG
GAGACCTAGGTGGTATGTG -> AGACCTAGGTGGTATGTGG
TGGAGAGCCTAGCCAGACG -> GGAGAGCCTAGCCAGACGC
CTGTTAGGTATACGACTTC -> TGTTAGGTATACGACTTCA
CCTGCGGTCTCCCGTTCTT -> CTGCGGTCTCCCGTTCTTG
GCATAGCCTGTGAGCTGTG -> CATAGCCTGTGAGCTGTGC
TGGTGCCTTCTTACGAAAA -> GGTGCCTTCTTACGAAAAA
AGACGGCGTAGGGAATTGT -> GACGGCGTAGGGAATTGTG
GTCACAAACGAATAGCATG -> TCACAAACGAATAGCATGA
GGTCGAATTAGCAGTGTAT -> GTCGAATTAGCAGTGTATA
TGCAACAAGTAGGTGGATA -> GCAACAAGTAGGTGGATAT
TCCTACATCCTAATACAGT -> CCTACATCCTAATACAGTG
AAATCAGCAACTGGTGCCT -> AATCAGCAACTGGTGCCTT
TGCACGGACACGTCATACG -> GCACGGACACGTCATACGT
TGCTATACACCGTGAATAA -> GCTATACACCGTGAATAAA
TTTCGGAACAATCGGCAGA -> TTCGGAACAATCGGCAGAG
TGGTCGCCTCTGCGCAGAT -> GGTCGCCTCTGCGCAGATT
TCTAGAGCCAAGCTTCAGG -> CTAGAGCCAAGCTTCAGGT
CCCGTAGAAACTACGTGTC -> CCGTAGAAACTACGTGTCT
TTAGGGAGACCTAGGTGGT -> TAGGGAGACCTAGGTGGTA
CTTGCACGGACACGTCATA -> TTGCACGGACACGTCATAC
TTCTTGTTACATTTGATGT -> TCTTGTTACATTTGATGTG
CGGTAAGTGAATGAAATAA -> GGTAAGTGAATGAAATAAG
AGTGGACCGCTCCGGATGT -> GTGGACCGCTCCGGATGTT
TTCCAAGCGTGTGGAGAGC -> TCCAAGCGTGTGGAGAGCC
ATGGCTCTGACGATGGTAT -> TGGCTCTGACGATGGTATT
TGAGGTCAGTCGTACCGTG -> GAGGTCAGTCGTACCGTGC
CTGCGCAGATTGCTTTCGG -> TGCGCAGATTGCTTTCGGA
GACTCTGGCGGACGGCTAA -> ACTCTGGCGGACGGCTAAA
CATACCCCGCTAAGAAAGG -> ATACCCCGCTAAGAAAGGT
AGTAACAGCATAACAAGAC -> GTAACAGCATAACAAGACG
GAACAATCGGCAGAGATCT -> AACAATCGGCAGAGATCTA
CTACATCCTAATACAGTGT -> TACATCCTAATACAGTGTC
GTGAATAAACCGGCTGATC -> TGAATAAACCGGCTGATCG
GAATATGGTGCATAGCCTG -> AATATGGTGCATAGCCTGT
TTGTTACATTGAGGGCTTA -> TGTTACATTGAGGGCTTAG
TGGATATGTCAAATTATCT -> GGATATGTCAAATTATCTG
GTTCTGAGAGGTCGGGGGG -> TTCTGAGAGGTCGGGGGGG
TACAGTGTCTATACGGACA -> ACAGTGTCTATACGGACAA
GTGACGCATTTTTAGTCCG -> TGACGCATTTTTAGTCCGT
GGCTTAATTTAGCGGCCGC -> GCTTAATTTAGCGGCCGCC
TTGTGAAATGCTTCGCATG -> TGTGAAATGCTTCGCATGG
GATGGAGCAACAGGGTGCA -> ATGGAGCAACAGGGTGCAC
GGGATCCTATCACCGGTAT -> GGATCCTATCACCGGTATA
GCCTAGCCAGACGCTGTTT -> CCTAGCCAGACGCTGTTTC
GCACTCCCGTTCTTGTTAC -> CACTCCCGTTCTTGTTACA
TCCAAAAAGGGGCTGTAGT -> CCAAAAAGGGGCTGTAGTA
AGCAACTGGTGCCTTCTTA -> GCAACTGGTGCCTTCTTAC
GAGTCCGGGAGATCCTGTG -> AGTCCGGGAGATCCTGTGA
ATCGGCAGAGATCTATTAG -> TCGGCAGAGATCTATTAGT
TCCCGTAGAAACTACGTGT -> CCCGTAGAAACTACGTGTC
ATAAAGTTCTTCTGGTCGA -> TAAAGTTCTTCTGGTCGAA
ACGCACGTCCCCTTCGACT -> CGCACGTCCCCTTCGACTA
CCGTTCTTGTTACATTAGT -> CGTTCTTGTTACATTAGTG,CGTTCTTGTTACATTAGTC
AAAACAGAAAATTCGGCTT -> AAACAGAAAATTCGGCTTG
AGGAGTTCTGAGAGGTCGG -> GGAGTTCTGAGAGGTCGGG
CGGACGGCTAAATCGCCAG -> GGACGGCTAAATCGCCAGA
AATTTGCCCCTCTCCGGGA -> ATTTGCCCCTCTCCGGGAA
AAAATCATGATCGTATAAA -> AAATCATGATCGTATAAAT
GACAATCTAATATCGATCC -> ACAATCTAATATCGATCCA
CGAATGAACCAATGCTAAG -> GAATGAACCAATGCTAAGA
ACAACATTAGCTTGGGCCT -> CAACATTAGCTTGGGCCTG
TCCCGTTCTTGTTACATTT -> CCCGTTCTTGTTACATTTG
GGCATAGGAGATTCACATG -> GCATAGGAGATTCACATGT
CCGTGCCTTCGCGACCCAA -> CGTGCCTTCGCGACCCAAC
CATCTTGCCCCACCGCCGG -> ATCTTGCCCCACCGCCGGT
TGCTAAGATTAGTTCGGAA -> GCTAAGATTAGTTCGGAAA
TCCTGTTCCTTATGGTTCG -> CCTGTTCCTTATGGTTCGC
GCGAATGTCGGGTGAAGCG -> CGAATGTCGGGTGAAGCGA
TACATGGCTCTGACGATGG -> ACATGGCTCTGACGATGGT
CGCCAGACGGTAAGTGAAT -> GCCAGACGGTAAGTGAATG
GCTTGAACAGTCACAAACG -> CTTGAACAGTCACAAACGA
TGCAATCGGGGGGCTTCGC -> GCAATCGGGGGGCTTCGCG
ACTTCACTTCAAGGAGTTA -> CTTCACTTCAAGGAGTTAC
GTTTCTTCCCATTGGAAAA -> TTTCTTCCCATTGGAAAAA
AGGATTTGTGCGGCCTCCC -> GGATTTGTGCGGCCTCCCG
TGACGATGGTATTGGGCAG -> GACGATGGTATTGGGCAGC
CGCACTCCCGTTCTTGTTA -> GCACTCCCGTTCTTGTTAC
CCGGTGAAGCCAGGAAGTA -> CGGTGAAGCCAGGAAGTAC
TGAAATAAGACTAGGCGGT -> GAAATAAGACTAGGCGGTG
GGCGTGTTCCCAGCGTGTT -> GCGTGTTCCCAGCGTGTTC
CTCTGCGCAGATTGCTTTC -> TCTGCGCAGATTGCTTTCG
CCATTTACCATATGCGAAA -> CATTTACCATATGCGAAAA
GCAATTTCAATCTTGGGGA -> CAATTTCAATCTTGGGGAC
TCACCTCAGCTTGCACGGA -> CACCTCAGCTTGCACGGAC
GTCACAGCACTGTATAGTA -> TCACAGCACTGTATAGTAG
GTTGGTAGCTATAGAGTGG -> TTGGTAGCTATAGAGTGGA
GTTCAAAGCGACCGACACG -> TTCAAAGCGACCGACACGT
GACTTCACTTCAAGGAGTT -> ACTTCACTTCAAGGAGTTA
GGGTGGGACTTAGGGCTCG -> GGTGGGACTTAGGGCTCGT
TTGCACGGACACGTCATAC -> TGCACGGACACGTCATACG
AGAGCCTAGCCAGACGCTG -> GAGCCTAGCCAGACGCTGT
GCGCAGATTGCTTTCGGAA -> CGCAGATTGCTTTCGGAAC
CTCCCCTTCTCCGTTCAAA -> TCCCCTTCTCCGTTCAAAC
CGCGGACGGATCTCATCAC -> GCGGACGGATCTCATCACC
CAAGACGGCGTAGGGAATT -> AAGACGGCGTAGGGAATTG
ACCAGAATGAAATAAGACT -> CCAGAATGAAATAAGACTA
AATGAAATAAGACTAGGCG -> ATGAAATAAGACTAGGCGG
CCACCCCAAGCTCGCCCTA -> CACCCCAAGCTCGCCCTAT
ACGTATTGGCAAAAATCGA -> CGTATTGGCAAAAATCGAT
TCACAAACGAATAGCATGA -> CACAAACGAATAGCATGAG
TAACAAGACGGCGTAGGGA -> AACAAGACGGCGTAGGGAA
ACTGTGCAATTTCAATCTT -> CTGTGCAATTTCAATCTTG
CACGTGCTATACACCGTGA -> ACGTGCTATACACCGTGAA
TCGCCTCTGCGCAGATTGC -> CGCCTCTGCGCAGATTGCT
GCTTAATTTAGCGGCCGCC -> CTTAATTTAGCGGCCGCCA
TCAAGATCTAGAGCCAAGC -> CAAGATCTAGAGCCAAGCT
TGATGTTGTCACGCGGACG -> GATGTTGTCACGCGGACGG
CAAGTAGGTGGATATGTCA -> AAGTAGGTGGATATGTCAA
ATGAAATAAGACTAGGCGG -> TGAAATAAGACTAGGCGGT
CAACCTTCCGTAAGCTAGG -> AACCTTCCGTAAGCTAGGA
TATACGGACAATCTAATAT -> ATACGGACAATCTAATATC
CGACTGAGCGCATACCCCG -> GACTGAGCGCATACCCCGC
AAGCGACCGACACGTGGTT -> AGCGACCGACACGTGGTTG
TGCATAGCCTGTGAGCTGT -> GCATAGCCTGTGAGCTGTG
GTGCCTTCGCGACCCAACT -> TGCCTTCGCGACCCAACTA
GGATGTTGCAGCACTACTA -> GATGTTGCAGCACTACTAT
CGTGACTCTGGCGGACGGC -> GTGACTCTGGCGGACGGCT
TTGGAAAAACTGATGTTGT -> TGGAAAAACTGATGTTGTC
AGCAACCATCTTGCCCCAC -> GCAACCATCTTGCCCCACC
AACTGATGTTGTCACGCGG -> ACTGATGTTGTCACGCGGA
TGTTTATTACCGGGTTTCT -> GTTTATTACCGGGTTTCTG
TTACCGGGTTTCTGACTGG -> TACCGGGTTTCTGACTGGT
ATAAGACTAGGTTGCCTGC -> TAAGACTAGGTTGCCTGCG
TGTCACGCGGACGGATCTC -> GTCACGCGGACGGATCTCA
GACGGTTCATCTACGATCT -> ACGGTTCATCTACGATCTT
GTTCTTGTTACATTAGTCA -> TTCTTGTTACATTAGTCAG
TCGGAACAATCGGCAGAGA -> CGGAACAATCGGCAGAGAT
GAGCAACAGGGTGCACAAA -> AGCAACAGGGTGCACAAAC
CATTCTGTTAGGTATACGA -> ATTCTGTTAGGTATACGAC
TGGGCCTGCTTGAACAGTC -> GGGCCTGCTTGAACAGTCA
ACCAATGCTAAGATTAGTT -> CCAATGCTAAGATTAGTTC
ATTTGCCCCTCTCCGGGAA -> TTTGCCCCTCTCCGGGAAT
TGTTCCTTATGGTTCGCCA -> GTTCCTTATGGTTCGCCAG
GAATGAACCAATGCTAAGA -> AATGAACCAATGCTAAGAT
CCGTTCCGTATGATCCATT -> CGTTCCGTATGATCCATTA
TTCACATGTCTGGCTGCAC -> TCACATGTCTGGCTGCACG
GAAGAATATGGTGCATAGC -> AAGAATATGGTGCATAGCC
GGTTCGCCAGAGCTCAGTT -> GTTCGCCAGAGCTCAGTTA
GTGTCTATACGGACAATCT -> TGTCTATACGGACAATCTA
ATACGGACAATCTAATATC -> TACGGACAATCTAATATCG
GTGATAAACTTCGTCCAAA -> TGATAAACTTCGTCCAAAA
GATGGCTCCGCAGTGCTCC -> ATGGCTCCGCAGTGCTCCC
GCCGAATGAACCAATGCTA -> CCGAATGAACCAATGCTAA
CGCCCTATCATGCAGCATC -> GCCCTATCATGCAGCATCT
GGCCTGCTTGAACAGTCAC -> GCCTGCTTGAACAGTCACA
GCCTTCTTACGAAAAAATC -> CCTTCTTACGAAAAAATCA
AACAAGTAGGTGGATATGT -> ACAAGTAGGTGGATATGTC
TGTCCCGCTCATGTGTCCC -> GTCCCGCTCATGTGTCCCT
GGTCTGCCATTTACCATAT -> GTCTGCCATTTACCATATG
TGGTTCGCCAGAGCTCAGT -> GGTTCGCCAGAGCTCAGTT
TTCTGTTGGTAGCTATAGA -> TCTGTTGGTAGCTATAGAG
GGAGCAACAGGGTGCACAA -> GAGCAACAGGGTGCACAAA
TCCTCGTTTTGTCGGAGGA -> CCTCGTTTTGTCGGAGGAG
TCCGGGAGATCCTGTGATA -> CCGGGAGATCCTGTGATAA
ATCGCCAGACGGTAAGTGA -> TCGCCAGACGGTAAGTGAA
TCGGATCAACCTTCCGTAA -> CGGATCAACCTTCCGTAAG
GACGGTAAGTGAATGAAAT -> ACGGTAAGTGAATGAAATA
TAGCTTGGGCCTGCTTGAA -> AGCTTGGGCCTGCTTGAAC
GGGCCGCTGAGACCAGAAT -> GGCCGCTGAGACCAGAATG
TTTATTACCGGGTTTCTGA -> TTATTACCGGGTTTCTGAC
TTCGGAACAATCGGCAGAG -> TCGGAACAATCGGCAGAGA
TGCGAATGTCGGGTGAAGC -> GCGAATGTCGGGTGAAGCG
CGGGTGAAGCGAAGAATAT -> GGGTGAAGCGAAGAATATG
GCAGAGATCTATTAGTGCA -> CAGAGATCTATTAGTGCAT
TGGGGACAGATTTTGGTCG -> GGGGACAGATTTTGGTCGA
GGAGGAGTCCGGGAGATCC -> GAGGAGTCCGGGAGATCCT
GAATGAAATAAGACTAGGC -> AATGAAATAAGACTAGGCG
ATGGGCTTAATTTAGCGGC -> TGGGCTTAATTTAGCGGCC
TCGGTGATTCGTCCTACAT -> CGGTGATTCGTCCTACATC
ACGAATGAAATAAGACTAG -> CGAATGAAATAAGACTAGG
TCCCGTTCTTGTTACATTG -> CCCGTTCTTGTTACATTGA
TCAAAGCGACCGACACGTG -> CAAAGCGACCGACACGTGG
GCTCCCGTAGAAACTACGT -> CTCCCGTAGAAACTACGTG
GACCAGAATGAAATAAGAC -> ACCAGAATGAAATAAGACT
ACACGTCATACGTATGTCG -> CACGTCATACGTATGTCGT
CATAGGAGATTCACATGTC -> ATAGGAGATTCACATGTCT
CGCGACTGAGCGCATACCC -> GCGACTGAGCGCATACCCC
TGTGGAGAGCCTAGCCAGA -> GTGGAGAGCCTAGCCAGAC
AGGGAATTGTGAAATGCTT -> GGGAATTGTGAAATGCTTC
GACCGACACGTGGTTGGCA -> ACCGACACGTGGTTGGCAG
CAAACCTTCAAAATAAATC -> AAACCTTCAAAATAAATCA
AACCTTCCGTAAGCTAGGA -> ACCTTCCGTAAGCTAGGAA
CAAAGCGACCGACACGTGG -> AAAGCGACCGACACGTGGT
AGATCTATTAGTGCATCAG -> GATCTATTAGTGCATCAGG
CGGATGTTGCAGCACTACT -> GGATGTTGCAGCACTACTA
CAGAATGAAATAAGACTAG -> AGAATGAAATAAGACTAGG
GTCGTACCGTGCCTTCGCG -> TCGTACCGTGCCTTCGCGA
TACATTAGTGGCATAGGAG -> ACATTAGTGGCATAGGAGA
TACCGTGCCTTCGCGACCC -> ACCGTGCCTTCGCGACCCA
GTGTGGAGAGCCTAGCCAG -> TGTGGAGAGCCTAGCCAGA
ATTGATGGCTCCGCAGTGC -> TTGATGGCTCCGCAGTGCT
GTAGGCAAACCTTCAAAAT -> TAGGCAAACCTTCAAAATA
AGTGTATAACCAAAGTAAC -> GTGTATAACCAAAGTAACA
TGTTACATTAGTCAGGTCT -> GTTACATTAGTCAGGTCTG
CGGGGATCCTATCACCGGT -> GGGGATCCTATCACCGGTA
CTATCATGCAGCATCTCCC -> TATCATGCAGCATCTCCCC
TCATCTACGATCTTCCTGT -> CATCTACGATCTTCCTGTT
TTTGTCGGAGGAGTCCGGG -> TTGTCGGAGGAGTCCGGGA
TGTTGGTAGCTATAGAGTG -> GTTGGTAGCTATAGAGTGG
AGGAGTCCGGGAGATCCTG -> GGAGTCCGGGAGATCCTGT
GACTAGGTTGCCTGCGGTC -> ACTAGGTTGCCTGCGGTCT
TGTTGTCACGCGGACGGAT -> GTTGTCACGCGGACGGATC
CAGGGTGCACAAACCGGGG -> AGGGTGCACAAACCGGGGG
TGACGGTTCATCTACGATC -> GACGGTTCATCTACGATCT
CGGATCTCATCACCTCAGC -> GGATCTCATCACCTCAGCT
TTTTGTCGGAGGAGTCCGG -> TTTGTCGGAGGAGTCCGGG
AAAATAAATCAGCAACTGG -> AAATAAATCAGCAACTGGT
CGATCCATGACTGTGCAAT -> GATCCATGACTGTGCAATT
GGGCTTAGCAACCATCTTG -> GGCTTAGCAACCATCTTGC
GTGGCATAGGAGATTCACA -> TGGCATAGGAGATTCACAT
ATGGAGTGCCGAATGAACC -> TGGAGTGCCGAATGAACCA
GAAAGGTGCGTGACTCTGG -> AAAGGTGCGTGACTCTGGC
TGATTCGTCCTACATCCTA -> GATTCGTCCTACATCCTAA
TTGCCATAGTCGGTGATTC -> TGCCATAGTCGGTGATTCG
CAGCACTGTATAGTAGCTA -> AGCACTGTATAGTAGCTAC
AGGTTGCCTGCGGTCTCCC -> GGTTGCCTGCGGTCTCCCG
GAGAGGTCGGGGGGGTCGT -> AGAGGTCGGGGGGGTCGTG
GGCTGCACGTGCTATACAC -> GCTGCACGTGCTATACACC
AGCAACAGGGTGCACAAAC -> GCAACAGGGTGCACAAACC
AACCTTGTCCTTCTGTCGT -> ACCTTGTCCTTCTGTCGTA
GCCGCCAACGTGACGCATT -> CCGCCAACGTGACGCATTT
AATACTACAGGTCACAGCA -> ATACTACAGGTCACAGCAC
TCGGGGGGGTCGTGCACGA -> CGGGGGGGTCGTGCACGAA
CCCCACCGCCGGTGAAGCC -> CCCACCGCCGGTGAAGCCA
GAATTGTGAAATGCTTCGC -> AATTGTGAAATGCTTCGCA
TCTCGTATATTGGTATACA -> CTCGTATATTGGTATACAT
CTTAATTTAGCGGCCGCCA -> TTAATTTAGCGGCCGCCAA
GGTCGGATCAACCTTCCGT -> GTCGGATCAACCTTCCGTA
TTGTTACATTTGATGTGTA -> TGTTACATTTGATGTGTAC
GCACGGCGCATTAATGGTC -> CACGGCGCATTAATGGTCG
CCAAGCTCGCCCTATCATG -> CAAGCTCGCCCTATCATGC
TTGTGCGGCCTCCCGTTCT -> TGTGCGGCCTCCCGTTCTT
GGTAGAGATTGGAGCATGG -> GTAGAGATTGGAGCATGGA
GAACCCTCACTACAACATT -> AACCCTCACTACAACATTA
TCGTGCACGAAGTCAAGAT -> CGTGCACGAAGTCAAGATC
TGGCTCTGACGATGGTATT -> GGCTCTGACGATGGTATTG
TTAGTCAGGTCTGCCATTT -> TAGTCAGGTCTGCCATTTA
CTCTCGTATATTGGTATAC -> TCTCGTATATTGGTATACA
ACCAACAATTTGCCCCTCT -> CCAACAATTTGCCCCTCTC
TACGTGTCTAGACTCGCAG -> ACGTGTCTAGACTCGCAGT
CGACTTCACGGGGATCCTA -> GACTTCACGGGGATCCTAT
AGTCAGGTCTGCCATTTAC -> GTCAGGTCTGCCATTTACC
CACAGCACTGTATAGTAGC -> ACAGCACTGTATAGTAGCT
GGTCAGTCGTACCGTGCCT -> GTCAGTCGTACCGTGCCTT
TCCCCTTCTCCGTTCAAAC -> CCCCTTCTCCGTTCAAACC
CTGTGCCCTGGAACCCTCA -> TGTGCCCTGGAACCCTCAC
GTCCTACATCCTAATACAG -> TCCTACATCCTAATACAGT
GCGGCCGCCAACGTGACGC -> CGGCCGCCAACGTGACGCA
CTTCGCGACCCAACTACGC -> TTCGCGACCCAACTACGCA
TCTCATCACCTCAGCTTGC -> CTCATCACCTCAGCTTGCA
TTTTTAGTCCGTTCCGTAT -> TTTTAGTCCGTTCCGTATG
ACCCCAAGCTCGCCCTATC -> CCCCAAGCTCGCCCTATCA
GCAAACCTTCAAAATAAAT -> CAAACCTTCAAAATAAATC
AAGTGAATGAAATAAGACT -> AGTGAATGAAATAAGACTA
CTCAGCTTGCACGGACACG -> TCAGCTTGCACGGACACGT
CCAGGTAGAGATTGGAGCA -> CAGGTAGAGATTGGAGCAT
CTGTTCCAAGCGTGTGGAG -> TGTTCCAAGCGTGTGGAGA
CAAAAATCGATATAATACT -> AAAAATCGATATAATACTA
TTGCTTTCGGAACAATCGG -> TGCTTTCGGAACAATCGGC
GACGGCTAAATCGCCAGAC -> ACGGCTAAATCGCCAGACG
GATTCACATGTCTGGCTGC -> ATTCACATGTCTGGCTGCA
TTCCTTATGGTTCGCCAGA -> TCCTTATGGTTCGCCAGAG
CGAAGTCAAGATCTAGAGC -> GAAGTCAAGATCTAGAGCC
CTGTCGTAAACAGCACGGC -> TGTCGTAAACAGCACGGCG
TCAAACCACACCCGACATG -> CAAACCACACCCGACATGG
GTCTATACGGACAATCTAA -> TCTATACGGACAATCTAAT
ATACCCCGCTAAGAAAGGT -> TACCCCGCTAAGAAAGGTG
CTACGATCTTCCTGTTCCT -> TACGATCTTCCTGTTCCTT
GGGGATCCTATCACCGGTA -> GGGATCCTATCACCGGTAT
ATGCAGCATCTCCCCTTCT -> TGCAGCATCTCCCCTTCTC
AACAGGGTGCACAAACCGG -> ACAGGGTGCACAAACCGGG
GGTGGAACGGGCCGCTGAG -> GTGGAACGGGCCGCTGAGA
AATATCGATCCATGACTGT -> ATATCGATCCATGACTGTG
TCTACGATCTTCCTGTTCC -> CTACGATCTTCCTGTTCCT
CCCTTCCTGTTCCAAGCGT -> CCTTCCTGTTCCAAGCGTG
GGTAAGTGAATGAAATAAG -> GTAAGTGAATGAAATAAGA
GTACCGTGCCTTCGCGACC -> TACCGTGCCTTCGCGACCC
TGTGCCCTGGAACCCTCAC -> GTGCCCTGGAACCCTCACT
TCATGATCGTATAAATGCA -> CATGATCGTATAAATGCAA
TCGAAAAGAATTATCCAGG -> CGAAAAGAATTATCCAGGT
TTCTGTTAGGTATACGACT -> TCTGTTAGGTATACGACTT
ACCGACGTCGTCACTACTT -> CCGACGTCGTCACTACTTT
ATCCAGGTAGAGATTGGAG -> TCCAGGTAGAGATTGGAGC
CAGCGAGAACGTATTGGCA -> AGCGAGAACGTATTGGCAA
ATAGTCGGTGATTCGTCCT -> TAGTCGGTGATTCGTCCTA
GCTAAGAAAGGTGCGTGAC -> CTAAGAAAGGTGCGTGACT
TACGAAAAAATCATGATCG -> ACGAAAAAATCATGATCGT
GTGCTATACACCGTGAATA -> TGCTATACACCGTGAATAA
GGGTGACGGTTCATCTACG -> GGTGACGGTTCATCTACGA
CTTCTGGTCGAATTAGCAG -> TTCTGGTCGAATTAGCAGT
TTGTCCTTCTGTCGTAAAC -> TGTCCTTCTGTCGTAAACA
TCCCAGCGTGTTCAAAGCG -> CCCAGCGTGTTCAAAGCGA
AAGACGGCGTAGGGAATTG -> AGACGGCGTAGGGAATTGT
CTCGATGGAGCAACAGGGT -> TCGATGGAGCAACAGGGTG
CTCATGTGTCCCTCTCGTA -> TCATGTGTCCCTCTCGTAT
GGGAGATCCTGTGATAAAC -> GGAGATCCTGTGATAAACT
TTCGCCAGAGCTCAGTTAC -> TCGCCAGAGCTCAGTTACG
GGTCGAAAAGAATTATCCA -> GTCGAAAAGAATTATCCAG
GCTGTATTGATGGCTCCGC -> CTGTATTGATGGCTCCGCA
CAGGTCTGCCATTTACCAT -> AGGTCTGCCATTTACCATA
ACCTTGTCCTTCTGTCGTA -> CCTTGTCCTTCTGTCGTAA
ATAGGAGATTCACATGTCT -> TAGGAGATTCACATGTCTG
GACATGGGCTTAATTTAGC -> ACATGGGCTTAATTTAGCG
GTGCCCTGGAACCCTCACT -> TGCCCTGGAACCCTCACTA
CCGCACTCCCGTTCTTGTT -> CGCACTCCCGTTCTTGTTA
CACGGGGATCCTATCACCG -> ACGGGGATCCTATCACCGG
ACCTTCAAAATAAATCAGC -> CCTTCAAAATAAATCAGCA
GTCGTGCACGAAGTCAAGA -> TCGTGCACGAAGTCAAGAT
TAAATCGCCAGACGGTAAG -> AAATCGCCAGACGGTAAGT
GCTAAATCGCCAGACGGTA -> CTAAATCGCCAGACGGTAA
CTACAACATTAGCTTGGGC -> TACAACATTAGCTTGGGCC
CGTATGATCCATTAAAGTC -> GTATGATCCATTAAAGTCT
ACTACGTGTCTAGACTCGC -> CTACGTGTCTAGACTCGCA
GAATAGCATGAGGTCAGTC -> AATAGCATGAGGTCAGTCG
CCTTCTCCGTTCAAACCAC -> CTTCTCCGTTCAAACCACA
ACGAAAAAATCATGATCGT -> CGAAAAAATCATGATCGTA
TTACGGGTGCGAATGTCGG -> TACGGGTGCGAATGTCGGG
GCACGTGCTATACACCGTG -> CACGTGCTATACACCGTGA
AGAGGTCGGGGGGGTCGTG -> GAGGTCGGGGGGGTCGTGC
CCCAACTACGCACGTCCCC -> CCAACTACGCACGTCCCCT
ACTAGGATTTGTGCGGCCT -> CTAGGATTTGTGCGGCCTC
CAGTGTCTATACGGACAAT -> AGTGTCTATACGGACAATC
CCGGACTCCCGTTCTTGTT -> CGGACTCCCGTTCTTGTTA
TCGTAGCGGTCTCGATGGA -> CGTAGCGGTCTCGATGGAG
TATACCGTGGGTCAGTACA -> ATACCGTGGGTCAGTACAA
ACACGTGGTTGGCAGCGAG -> CACGTGGTTGGCAGCGAGA
TGCCGAATGAACCAATGCT -> GCCGAATGAACCAATGCTA
TCCTATCACCGGTATAGCA -> CCTATCACCGGTATAGCAA
TCGCGACCCAACTACGCAC -> CGCGACCCAACTACGCACG
AGCACTACTATTGGGTGAC -> GCACTACTATTGGGTGACG
TCCATGACTGTGCAATTTC -> CCATGACTGTGCAATTTCA
TCTGGCTGCACGTGCTATA -> CTGGCTGCACGTGCTATAC
GCTAGGAACACCAACAATT -> CTAGGAACACCAACAATTT
ATTTAGCGGCCGCCAACGT -> TTTAGCGGCCGCCAACGTG
CAGCATCTCCCCTTCTCCG -> AGCATCTCCCCTTCTCCGT
GGGAATGAAATAAGACTAG -> GGAATGAAATAAGACTAGG
AGGGGCTGTAGTAGGCAAA -> GGGGCTGTAGTAGGCAAAC
GAGCTCAGTTACGGGTGCG -> AGCTCAGTTACGGGTGCGA
TATAACCAAAGTAACAGCA -> ATAACCAAAGTAACAGCAT
CCATAAAGTTCTTCTGGTC -> CATAAAGTTCTTCTGGTCG
TGAAATAAGACTAGGGTTG -> GAAATAAGACTAGGGTTGC
ATGTCGTTAAACCTTGTCC -> TGTCGTTAAACCTTGTCCT
GGTATTGGGCAGCTGTGGG -> GTATTGGGCAGCTGTGGGT
TCATGCAGCATCTCCCCTT -> CATGCAGCATCTCCCCTTC
CCTACATCCTAATACAGTG -> CTACATCCTAATACAGTGT
TGGAACCCTTCCTGTTCCA -> GGAACCCTTCCTGTTCCAA
CAATTAGGGAGACCTAGGT -> AATTAGGGAGACCTAGGTG
AATAGGAGTTCTGAGAGGT -> ATAGGAGTTCTGAGAGGTC
TTAGCTTGGGCCTGCTTGA -> TAGCTTGGGCCTGCTTGAA
GGTCAGTACAATTGGGCTG -> GTCAGTACAATTGGGCTGT
TTCCCATTGGAAAAACTGA -> TCCCATTGGAAAAACTGAT
GTTCAAACCACACCCGACA -> TTCAAACCACACCCGACAT
TGGGCAGCTGTGGGTGGGA -> GGGCAGCTGTGGGTGGGAC
GTAAGTGAATGAAATAAGA -> TAAGTGAATGAAATAAGAC
CGTATTGGCAAAAATCGAT -> GTATTGGCAAAAATCGATA
ATGGTTCGCCAGAGCTCAG -> TGGTTCGCCAGAGCTCAGT
GAAGTCAAGATCTAGAGCC -> AAGTCAAGATCTAGAGCCA
CGAATAGCATGAGGTCAGT -> GAATAGCATGAGGTCAGTC
ATGGAACGAATGAAATAAG -> TGGAACGAATGAAATAAGA
TATTGATGGCTCCGCAGTG -> ATTGATGGCTCCGCAGTGC
TAGGGAGACCTAGGTGGTA -> AGGGAGACCTAGGTGGTAT
CCGTGAATAAACCGGCTGA -> CGTGAATAAACCGGCTGAT
AGCTAGGAACACCAACAAT -> GCTAGGAACACCAACAATT
GGAACCCTTCCTGTTCCAA -> GAACCCTTCCTGTTCCAAG
ACCCGACATGGGCTTAATT -> CCCGACATGGGCTTAATTT
CATTAGTCAGGTCTGCCAT -> ATTAGTCAGGTCTGCCATT
TAACAGCATAACAAGACGG -> AACAGCATAACAAGACGGC
GCCTGCTTGAACAGTCACA -> CCTGCTTGAACAGTCACAA
CCGTGGGTCAGTACAATTG -> CGTGGGTCAGTACAATTGG
GGTGACGGTTCATCTACGA -> GTGACGGTTCATCTACGAT
AAATCGCCAGACGGTAAGT -> AATCGCCAGACGGTAAGTG
ATCACCGGTATAGCAATTG -> TCACCGGTATAGCAATTGC
CGTGAATAAACCGGCTGAT -> GTGAATAAACCGGCTGATC
TACAGGTCACAGCACTGTA -> ACAGGTCACAGCACTGTAT
CGGGAGATCCTGTGATAAA -> GGGAGATCCTGTGATAAAC
ACAGTCACAAACGAATAGC -> CAGTCACAAACGAATAGCA
ATACATATACCGTGGGTCA -> TACATATACCGTGGGTCAG
GGGTGCACAAACCGGGGGG -> GGTGCACAAACCGGGGGGG
AGGTATACGACTTCACGGG -> GGTATACGACTTCACGGGG
GAGGAGTCCGGGAGATCCT -> AGGAGTCCGGGAGATCCTG
TTGGTAGCTATAGAGTGGA -> TGGTAGCTATAGAGTGGAC
AGGTAGAGATTGGAGCATG -> GGTAGAGATTGGAGCATGG
CATTAGTGGCATAGGAGAT -> ATTAGTGGCATAGGAGATT
GGGTGAAGCGAAGAATATG -> GGTGAAGCGAAGAATATGG
AACGCAATTAGGGAGACCT -> ACGCAATTAGGGAGACCTA
GTCAAATTATCTGCATTGT -> TCAAATTATCTGCATTGTG
TAAACCGGCTGATCGCGAC -> AAACCGGCTGATCGCGACT
ACACCCGACATGGGCTTAA -> CACCCGACATGGGCTTAAT
CCAACAATTTGCCCCTCTC -> CAACAATTTGCCCCTCTCC
CACACCCGACATGGGCTTA -> ACACCCGACATGGGCTTAA
AGATGGAGTGCCGAATGAA -> GATGGAGTGCCGAATGAAC
CACTACAACATTAGCTTGG -> ACTACAACATTAGCTTGGG
CGGGGGGCTTCGCGCACTA -> GGGGGGCTTCGCGCACTAC
TAATTTAGCGGCCGCCAAC -> AATTTAGCGGCCGCCAACG
CAAGGTGCCCGTCATTCTG -> AAGGTGCCCGTCATTCTGT
CGTATATTGGTATACATAT -> GTATATTGGTATACATATA
GTAGATGGAGTGCCGAATG -> TAGATGGAGTGCCGAATGA
CGTGTGGAGAGCCTAGCCA -> GTGTGGAGAGCCTAGCCAG
AATAAGACTAGGTTGCCTG -> ATAAGACTAGGTTGCCTGC
GTGCGGTGGAACGGGCCGC -> TGCGGTGGAACGGGCCGCT
GTTGGCAGCGAGAACGTAT -> TTGGCAGCGAGAACGTATT
GTCACGCGGACGGATCTCA -> TCACGCGGACGGATCTCAT
TCTATTCTATCCTCGTTTT -> CTATTCTATCCTCGTTTTG
TGCCCCACCGCCGGTGAAG -> GCCCCACCGCCGGTGAAGC
CTCGCAGTTTCTGTTGGTA -> TCGCAGTTTCTGTTGGTAG
GGCCTCCCGTTCTTGTTAC -> GCCTCCCGTTCTTGTTACA
TTACATTTGATGTGTACTG -> TACATTTGATGTGTACTGC
TTATGTTTATTACCGGGTT -> TATGTTTATTACCGGGTTT
GGCAGCTGTGGGTGGGACT -> GCAGCTGTGGGTGGGACTT
CTACTTTCATACATGGCTC -> TACTTTCATACATGGCTCT
GTCTATTCTATCCTCGTTT -> TCTATTCTATCCTCGTTTT
AGTCGGTGATTCGTCCTAC -> GTCGGTGATTCGTCCTACA
CAAAGTAACAGCATAACAA -> AAAGTAACAGCATAACAAG
GCAGCATCTCCCCTTCTCC -> CAGCATCTCCCCTTCTCCG
TTCTGGTCGAATTAGCAGT -> TCTGGTCGAATTAGCAGTG
CTAGGAACACCAACAATTT -> TAGGAACACCAACAATTTG
GTGTCCCTCTCGTATATTG -> TGTCCCTCTCGTATATTGG
AGTGCTCCCGTAGAAACTA -> GTGCTCCCGTAGAAACTAC
ATATACCGTGGGTCAGTAC -> TATACCGTGGGTCAGTACA
CTCCCGTAGAAACTACGTG -> TCCCGTAGAAACTACGTGT
CGCGCACTACCCATTACGG -> GCGCACTACCCATTACGGA
CGTACCGTGCCTTCGCGAC -> GTACCGTGCCTTCGCGACC
GTCATACGTATGTCGTTAA -> TCATACGTATGTCGTTAAA
CGGCCTCCCGTTCTTGTTA -> GGCCTCCCGTTCTTGTTAC
ACACCGTGAATAAACCGGC -> CACCGTGAATAAACCGGCT
CGGATAACAAGGTGCCCGT -> GGATAACAAGGTGCCCGTC
TATGTTTATTACCGGGTTT -> ATGTTTATTACCGGGTTTC
TGGAACCCTCACTACAACA -> GGAACCCTCACTACAACAT
ATAACAAGACGGCGTAGGG -> TAACAAGACGGCGTAGGGA
AGTGAATGAAATAAGACTA -> GTGAATGAAATAAGACTAG
AAATGCAACAAGTAGGTGG -> AATGCAACAAGTAGGTGGA
GTAGGGAATTGTGAAATGC -> TAGGGAATTGTGAAATGCT
ATACAGTGTCTATACGGAC -> TACAGTGTCTATACGGACA
TCATACATGGCTCTGACGA -> CATACATGGCTCTGACGAT
GTAGAGATTGGAGCATGGA -> TAGAGATTGGAGCATGGAC
ACTGCAATCGGGGGGCTTC -> CTGCAATCGGGGGGCTTCG
CGGGGGGGTCGTGCACGAA -> GGGGGGGTCGTGCACGAAG
GCAGTAGATGGAGTGCCGA -> CAGTAGATGGAGTGCCGAA
AGTCGTACCGTGCCTTCGC -> GTCGTACCGTGCCTTCGCG
ATCGGGGGGCTTCGCGCAC -> TCGGGGGGCTTCGCGCACT
TCTTCTGGTCGAATTAGCA -> CTTCTGGTCGAATTAGCAG
AAACCGGGGGGGAACGCAA -> AACCGGGGGGGAACGCAAT
ATGAAATAAGACTAGGGTT -> TGAAATAAGACTAGGGTTG
ATCCTCGTTTTGTCGGAGG -> TCCTCGTTTTGTCGGAGGA
TAGTTCGGAAATAGGAGTT -> AGTTCGGAAATAGGAGTTC
CGGACTCCCGTTCTTGTTA -> GGACTCCCGTTCTTGTTAC
CGCTGAGACCAGAATGAAA -> GCTGAGACCAGAATGAAAT
GGAAATAGGAGTTCTGAGA -> GAAATAGGAGTTCTGAGAG
ATGTTGCAGCACTACTATT -> TGTTGCAGCACTACTATTG
CAATCTAATATCGATCCAT -> AATCTAATATCGATCCATG
GCGCATTAATGGTCGCCTC -> CGCATTAATGGTCGCCTCT
CTCACTACAACATTAGCTT -> TCACTACAACATTAGCTTG
ATTGGAGCATGGACTTCAC -> TTGGAGCATGGACTTCACT
CGACCCAACTACGCACGTC -> GACCCAACTACGCACGTCC
CTTGGGGACAGATTTTGGT -> TTGGGGACAGATTTTGGTC
TACTTTCATACATGGCTCT -> ACTTTCATACATGGCTCTG
GCTTCGCATGGAACGAATG -> CTTCGCATGGAACGAATGA
AGTAGGTGGATATGTCAAA -> GTAGGTGGATATGTCAAAT
CTCTGACGATGGTATTGGG -> TCTGACGATGGTATTGGGC
TGGACCGCTCCGGATGTTG -> GGACCGCTCCGGATGTTGC
CGCATACCCCGCTAAGAAA -> GCATACCCCGCTAAGAAAG
GTTACATTAGTCAGGTCTG -> TTACATTAGTCAGGTCTGC
CCTGCTTGAACAGTCACAA -> CTGCTTGAACAGTCACAAA
AATCTAATATCGATCCATG -> ATCTAATATCGATCCATGA
TACTCGCAGTAGATGGAGT -> ACTCGCAGTAGATGGAGTG
CCGTTCTTGTTACATTTGA -> CGTTCTTGTTACATTTGAT
AAAGGTGCGTGACTCTGGC -> AAGGTGCGTGACTCTGGCG
ATAAACCGGCTGATCGCGA -> TAAACCGGCTGATCGCGAC
ATCGATCCATGACTGTGCA -> TCGATCCATGACTGTGCAA
GGAGTTACCATAAAGTTCT -> GAGTTACCATAAAGTTCTT
CTGCGGTCTCCCGTTCTTG -> TGCGGTCTCCCGTTCTTGT
GGTGAAGCGAAGAATATGG -> GTGAAGCGAAGAATATGGT
GGGACAGATTTTGGTCGAA -> GGACAGATTTTGGTCGAAA
GGGTCGTGCACGAAGTCAA -> GGTCGTGCACGAAGTCAAG
ATCCATGACTGTGCAATTT -> TCCATGACTGTGCAATTTC
CACGGCGCATTAATGGTCG -> ACGGCGCATTAATGGTCGC
AATAAGACTAGGCGGTGCC -> ATAAGACTAGGCGGTGCCC
AGCTTGCACGGACACGTCA -> GCTTGCACGGACACGTCAT
TGGCTCCGCAGTGCTCCCG -> GGCTCCGCAGTGCTCCCGT
GTCGGGTGAAGCGAAGAAT -> TCGGGTGAAGCGAAGAATA
TGTTAGGTATACGACTTCA -> GTTAGGTATACGACTTCAC
GTCGTAAACAGCACGGCGC -> TCGTAAACAGCACGGCGCA
AATGCTTCGCATGGAACGA -> ATGCTTCGCATGGAACGAA
GTGCGAATGTCGGGTGAAG -> TGCGAATGTCGGGTGAAGC
AGGAGATTCACATGTCTGG -> GGAGATTCACATGTCTGGC
TCTATCCTCGTTTTGTCGG -> CTATCCTCGTTTTGTCGGA
GTCGGTGATTCGTCCTACA -> TCGGTGATTCGTCCTACAT
AAGCGTGTGGAGAGCCTAG -> AGCGTGTGGAGAGCCTAGC
CCCCAAGCTCGCCCTATCA -> CCCAAGCTCGCCCTATCAT
CGGGTGCGAATGTCGGGTG -> GGGTGCGAATGTCGGGTGA
AGATTTTGGTCGAAAAGAA -> GATTTTGGTCGAAAAGAAT
ACTACTTTCATACATGGCT -> CTACTTTCATACATGGCTC
GTCACTACTTTCATACATG -> TCACTACTTTCATACATGG
CGTGACGCATTTTTAGTCC -> GTGACGCATTTTTAGTCCG
TTACCATAAAGTTCTTCTG -> TACCATAAAGTTCTTCTGG
CTACTATTGGGTGACGGTT -> TACTATTGGGTGACGGTTC
TCGACTAGTGCGGTGGAAC -> CGACTAGTGCGGTGGAACG
TCGCGACTGAGCGCATACC -> CGCGACTGAGCGCATACCC
TGGGACTTAGGGCTCGTAG -> GGGACTTAGGGCTCGTAGC
CGGTGCCCGCACTCCCGTT -> GGTGCCCGCACTCCCGTTC
CCGCTCATGTGTCCCTCTC -> CGCTCATGTGTCCCTCTCG
AGGGCTTAGCAACCATCTT -> GGGCTTAGCAACCATCTTG
GCTGAGACCAGAATGAAAT -> CTGAGACCAGAATGAAATA
CTATTGGGTGACGGTTCAT -> TATTGGGTGACGGTTCATC
AAGTAGGTGGATATGTCAA -> AGTAGGTGGATATGTCAAA
TATACATATACCGTGGGTC -> ATACATATACCGTGGGTCA
GTGAAGCGAAGAATATGGT -> TGAAGCGAAGAATATGGTG
AACTTCGTCCAAAAAGGGG -> ACTTCGTCCAAAAAGGGGC
AGCTGTGGGTGGGACTTAG -> GCTGTGGGTGGGACTTAGG
AGAATGAAATAAGACTAGG -> GAATGAAATAAGACTAGGA
CAGATTGCTTTCGGAACAA -> AGATTGCTTTCGGAACAAT
GGGGGGGAACGCAATTAGG -> GGGGGGAACGCAATTAGGG
ACTACGCACGTCCCCTTCG -> CTACGCACGTCCCCTTCGA
AACCGGCTGATCGCGACTG -> ACCGGCTGATCGCGACTGA
CATTTACCATATGCGAAAA -> ATTTACCATATGCGAAAAC
CCCGACATGGGCTTAATTT -> CCGACATGGGCTTAATTTA
GCACTACCCATTACGGATA -> CACTACCCATTACGGATAA
TCATCACCTCAGCTTGCAC -> CATCACCTCAGCTTGCACG
GATCTTCCTGTTCCTTATG -> ATCTTCCTGTTCCTTATGG
AACGGGCCGCTGAGACCAG -> ACGGGCCGCTGAGACCAGA
ACCCAACTACGCACGTCCC -> CCCAACTACGCACGTCCCC
TCGGGTGAAGCGAAGAATA -> CGGGTGAAGCGAAGAATAT
GATCTAGAGCCAAGCTTCA -> ATCTAGAGCCAAGCTTCAG
TTAGCAACCATCTTGCCCC -> TAGCAACCATCTTGCCCCA
ACCGCCGGTGAAGCCAGGA -> CCGCCGGTGAAGCCAGGAA
AAGCGAAGAATATGGTGCA -> AGCGAAGAATATGGTGCAT
CTGGTCGGATCAACCTTCC -> TGGTCGGATCAACCTTCCG
GCTCCGGATGTTGCAGCAC -> CTCCGGATGTTGCAGCACT
GCGACCCAACTACGCACGT -> CGACCCAACTACGCACGTC
TCTATACGGACAATCTAAT -> CTATACGGACAATCTAATA
GTGAATGAAATAAGACTAG -> TGAATGAAATAAGACTAGG
CCAGACGCTGTTTCTTCCC -> CAGACGCTGTTTCTTCCCA
GGCAAAAATCGATATAATA -> GCAAAAATCGATATAATAC
CACTACCCATTACGGATAA -> ACTACCCATTACGGATAAC
CGGTTCATCTACGATCTTC -> GGTTCATCTACGATCTTCC
GGTGGATATGTCAAATTAT -> GTGGATATGTCAAATTATC
GCAACAGGGTGCACAAACC -> CAACAGGGTGCACAAACCG
GAGCGCATACCCCGCTAAG -> AGCGCATACCCCGCTAAGA
ACCATATGCGAAAACAGAA -> CCATATGCGAAAACAGAAA
AAAGTAACAGCATAACAAG -> AAGTAACAGCATAACAAGA
TGCCTTCTTACGAAAAAAT -> GCCTTCTTACGAAAAAATC
CCGAATGAACCAATGCTAA -> CGAATGAACCAATGCTAAG
ATTGAGGGCTTAGCAACCA -> TTGAGGGCTTAGCAACCAT
ATGCAACAAGTAGGTGGAT -> TGCAACAAGTAGGTGGATA
CATGGGCTTAATTTAGCGG -> ATGGGCTTAATTTAGCGGC
GTTGTCACGCGGACGGATC -> TTGTCACGCGGACGGATCT
GATTAGTTCGGAAATAGGA -> ATTAGTTCGGAAATAGGAG
ATGAGGTCAGTCGTACCGT -> TGAGGTCAGTCGTACCGTG
ACTGGTCGGATCAACCTTC -> CTGGTCGGATCAACCTTCC
AATTATCTGCATTGTGGAA -> ATTATCTGCATTGTGGAAC
AAAACTGATGTTGTCACGC -> AAACTGATGTTGTCACGCG
CAAACGAATAGCATGAGGT -> AAACGAATAGCATGAGGTC
GTGGAGAGCCTAGCCAGAC -> TGGAGAGCCTAGCCAGACG
CAAGGAGTTACCATAAAGT -> AAGGAGTTACCATAAAGTT
CGTCACTACTTTCATACAT -> GTCACTACTTTCATACATG
AATTGCCATAGTCGGTGAT -> ATTGCCATAGTCGGTGATT
TGGCAAAAATCGATATAAT -> GGCAAAAATCGATATAATA
ATCCTGTGATAAACTTCGT -> TCCTGTGATAAACTTCGTC
CTCGCAGTAGATGGAGTGC -> TCGCAGTAGATGGAGTGCC
AAATAAGACTAGGTTGCCT -> AATAAGACTAGGTTGCCTG
TCAGGTGACAATGTCCCGC -> CAGGTGACAATGTCCCGCT
CCATATGCGAAAACAGAAA -> CATATGCGAAAACAGAAAA
AGAATTATCCAGGTAGAGA -> GAATTATCCAGGTAGAGAT
TCCGCAGTGCTCCCGTAGA -> CCGCAGTGCTCCCGTAGAA
CAAACCACACCCGACATGG -> AAACCACACCCGACATGGG
GACTTCACGGGGATCCTAT -> ACTTCACGGGGATCCTATC
CAGCTGTGGGTGGGACTTA -> AGCTGTGGGTGGGACTTAG
GACACGTCATACGTATGTC -> ACACGTCATACGTATGTCG
CCCTTCGACTAGTGCGGTG -> CCTTCGACTAGTGCGGTGG
TGTGGCGTGTTCCCAGCGT -> GTGGCGTGTTCCCAGCGTG
AAGTACCACCACCCCAAGC -> AGTACCACCACCCCAAGCT
AGTTACCATAAAGTTCTTC -> GTTACCATAAAGTTCTTCT
ACCCCGCTAAGAAAGGTGC -> CCCCGCTAAGAAAGGTGCG
ATGGCTCCGCAGTGCTCCC -> TGGCTCCGCAGTGCTCCCG
CGAAAAGAATTATCCAGGT -> GAAAAGAATTATCCAGGTA
CTTCCTGTTCCAAGCGTGT -> TTCCTGTTCCAAGCGTGTG
GTTAGGTATACGACTTCAC -> TTAGGTATACGACTTCACG
TTATCCAGGTAGAGATTGG -> TATCCAGGTAGAGATTGGA
GTCGTTAAACCTTGTCCTT -> TCGTTAAACCTTGTCCTTC
CCCTGGAACCCTCACTACA -> CCTGGAACCCTCACTACAA
GCTCGTAGCGGTCTCGATG -> CTCGTAGCGGTCTCGATGG
GTACCACCACCCCAAGCTC -> TACCACCACCCCAAGCTCG
GGACTTAGGGCTCGTAGCG -> GACTTAGGGCTCGTAGCGG
TGCGGTCTCCCGTTCTTGT -> GCGGTCTCCCGTTCTTGTT
ACGTGACGCATTTTTAGTC -> CGTGACGCATTTTTAGTCC
GGTCGGGGGGGTCGTGCAC -> GTCGGGGGGGTCGTGCACG
CGTCCTACATCCTAATACA -> GTCCTACATCCTAATACAG
GGTATAGCAATTGCCATAG -> GTATAGCAATTGCCATAGT
TGTATAACCAAAGTAACAG -> GTATAACCAAAGTAACAGC
TGGTATTGGGCAGCTGTGG -> GGTATTGGGCAGCTGTGGG
TCGCATGGAACGAATGAAA -> CGCATGGAACGAATGAAAT
AAACAGCACGGCGCATTAA -> AACAGCACGGCGCATTAAT
GACGTCGTCACTACTTTCA -> ACGTCGTCACTACTTTCAT
GATCGTATAAATGCAACAA -> ATCGTATAAATGCAACAAG
GAACGCAATTAGGGAGACC -> AACGCAATTAGGGAGACCT
AAAGGGGCTGTAGTAGGCA -> AAGGGGCTGTAGTAGGCAA
TAGCAACCATCTTGCCCCA -> AGCAACCATCTTGCCCCAC
CACCGCCGGTGAAGCCAGG -> ACCGCCGGTGAAGCCAGGA
TGTATTGATGGCTCCGCAG -> GTATTGATGGCTCCGCAGT
TCACTACAACATTAGCTTG -> CACTACAACATTAGCTTGG
GCCTTCGCGACCCAACTAC -> CCTTCGCGACCCAACTACG
CTTCGACTAGTGCGGTGGA -> TTCGACTAGTGCGGTGGAA
CTGTATTGATGGCTCCGCA -> TGTATTGATGGCTCCGCAG
CCCTTCTCCGTTCAAACCA -> CCTTCTCCGTTCAAACCAC
TGTCTGGCTGCACGTGCTA -> GTCTGGCTGCACGTGCTAT
GTGTCTAGACTCGCAGTTT -> TGTCTAGACTCGCAGTTTC
AAGGAGTTACCATAAAGTT -> AGGAGTTACCATAAAGTTC
GTCAAGATCTAGAGCCAAG -> TCAAGATCTAGAGCCAAGC
GTAGCTACTCGCAGTAGAT -> TAGCTACTCGCAGTAGATG
CAATGTCCCGCTCATGTGT -> AATGTCCCGCTCATGTGTC
ATTGGGTGACGGTTCATCT -> TTGGGTGACGGTTCATCTA
CCTCACTACAACATTAGCT -> CTCACTACAACATTAGCTT
AAACTACGTGTCTAGACTC -> AACTACGTGTCTAGACTCG
TCGTCCTACATCCTAATAC -> CGTCCTACATCCTAATACA
TCGTCACTACTTTCATACA -> CGTCACTACTTTCATACAT
GCTCCGCAGTGCTCCCGTA -> CTCCGCAGTGCTCCCGTAG
ACCGGTATAGCAATTGCCA -> CCGGTATAGCAATTGCCAT
ACTGATGTTGTCACGCGGA -> CTGATGTTGTCACGCGGAC
GTCCAAAAAGGGGCTGTAG -> TCCAAAAAGGGGCTGTAGT
TCACGCGGACGGATCTCAT -> CACGCGGACGGATCTCATC
GAGGGCTTAGCAACCATCT -> AGGGCTTAGCAACCATCTT
GCAGCGAGAACGTATTGGC -> CAGCGAGAACGTATTGGCA
AACAAGACGGCGTAGGGAA -> ACAAGACGGCGTAGGGAAT
ACTACAACATTAGCTTGGG -> CTACAACATTAGCTTGGGC
CCCAAGCTCGCCCTATCAT -> CCAAGCTCGCCCTATCATG
TTAGGTATACGACTTCACG -> TAGGTATACGACTTCACGG
TATCGATCCATGACTGTGC -> ATCGATCCATGACTGTGCA
GGTGCACAAACCGGGGGGG -> GTGCACAAACCGGGGGGGA
GCCTGCGGTCTCCCGTTCT -> CCTGCGGTCTCCCGTTCTT
TTTCTGACTGGTCGGATCA -> TTCTGACTGGTCGGATCAA
AGAAACTACGTGTCTAGAC -> GAAACTACGTGTCTAGACT
AGGCAAACCTTCAAAATAA -> GGCAAACCTTCAAAATAAA
AATAAGACTAGGGTTGCTC -> ATAAGACTAGGGTTGCTCC
TAGGATTTGTGCGGCCTCC -> AGGATTTGTGCGGCCTCCC
TCAGTCGTACCGTGCCTTC -> CAGTCGTACCGTGCCTTCG
GGAAAAACTGATGTTGTCA -> GAAAAACTGATGTTGTCAC
TTCTGTCGTAAACAGCACG -> TCTGTCGTAAACAGCACGG
TGGGTGACGGTTCATCTAC -> GGGTGACGGTTCATCTACG
CACGCGGACGGATCTCATC -> ACGCGGACGGATCTCATCA
TAAGATTAGTTCGGAAATA -> AAGATTAGTTCGGAAATAG
TACATCCTAATACAGTGTC -> ACATCCTAATACAGTGTCT
AATCTTGGGGACAGATTTT -> ATCTTGGGGACAGATTTTG
TGTTCCCAGCGTGTTCAAA -> GTTCCCAGCGTGTTCAAAG
CTGTAGTAGGCAAACCTTC -> TGTAGTAGGCAAACCTTCA
CGTAGCGGTCTCGATGGAG -> GTAGCGGTCTCGATGGAGC
CTTCACTTCAAGGAGTTAC -> TTCACTTCAAGGAGTTACC
GGCTGTAGTAGGCAAACCT -> GCTGTAGTAGGCAAACCTT
TCGTCCAAAAAGGGGCTGT -> CGTCCAAAAAGGGGCTGTA
CGTCATACGTATGTCGTTA -> GTCATACGTATGTCGTTAA
GGGTTGCTCCGGACTCCCG -> GGTTGCTCCGGACTCCCGT
CGTAAACAGCACGGCGCAT -> GTAAACAGCACGGCGCATT
ATGTTGTCACGCGGACGGA -> TGTTGTCACGCGGACGGAT
TACGATCTTCCTGTTCCTT -> ACGATCTTCCTGTTCCTTA
GTGCACGAAGTCAAGATCT -> TGCACGAAGTCAAGATCTA
GGTGCCTTCTTACGAAAAA -> GTGCCTTCTTACGAAAAAA
AAGTAACAGCATAACAAGA -> AGTAACAGCATAACAAGAC
GCCCGCACTCCCGTTCTTG -> CCCGCACTCCCGTTCTTGT
ACGTGTCTAGACTCGCAGT -> CGTGTCTAGACTCGCAGTT
CGGACAATCTAATATCGAT -> GGACAATCTAATATCGATC
CGGGCCGCTGAGACCAGAA -> GGGCCGCTGAGACCAGAAT
GGCTCTGACGATGGTATTG -> GCTCTGACGATGGTATTGG
AGTTCTTCTGGTCGAATTA -> GTTCTTCTGGTCGAATTAG
TAAAGTTCTTCTGGTCGAA -> AAAGTTCTTCTGGTCGAAT
AGCGGCCGCCAACGTGACG -> GCGGCCGCCAACGTGACGC
GGATTATGTTTATTACCGG -> GATTATGTTTATTACCGGG
CCCCTCTCCGGGAATGAAA -> CCCTCTCCGGGAATGAAAT
CCGTCATTCTGTTAGGTAT -> CGTCATTCTGTTAGGTATA
ACCTAGGTGGTATGTGGCG -> CCTAGGTGGTATGTGGCGT
TCCAGGTAGAGATTGGAGC -> CCAGGTAGAGATTGGAGCA
GGTTTCTGACTGGTCGGAT -> GTTTCTGACTGGTCGGATC
CGGCAGAGATCTATTAGTG -> GGCAGAGATCTATTAGTGC
ACGTATGTCGTTAAACCTT -> CGTATGTCGTTAAACCTTG
GCTGTTTCTTCCCATTGGA -> CTGTTTCTTCCCATTGGAA
CGGACACGTCATACGTATG -> GGACACGTCATACGTATGT
TGTATAGTAGCTACTCGCA -> GTATAGTAGCTACTCGCAG
TCTGAGAGGTCGGGGGGGT -> CTGAGAGGTCGGGGGGGTC
CGAATGAAATAAGACTAGG -> GAATGAAATAAGACTAGGC
ACTACAGGTCACAGCACTG -> CTACAGGTCACAGCACTGT
AAGAAAGGTGCGTGACTCT -> AGAAAGGTGCGTGACTCTG
GTAGCTATAGAGTGGACCG -> TAGCTATAGAGTGGACCGC
ATACGACTTCACGGGGATC -> TACGACTTCACGGGGATCC
GAGCCTAGCCAGACGCTGT -> AGCCTAGCCAGACGCTGTT
TTAATGGTCGCCTCTGCGC -> TAATGGTCGCCTCTGCGCA
ATATGCGAAAACAGAAAAT -> TATGCGAAAACAGAAAATT
CCAAAGTAACAGCATAACA -> CAAAGTAACAGCATAACAA
GGGAATTGTGAAATGCTTC -> GGAATTGTGAAATGCTTCG
TACTACAGGTCACAGCACT -> ACTACAGGTCACAGCACTG
ATCGCGACTGAGCGCATAC -> TCGCGACTGAGCGCATACC
GAAGTACCACCACCCCAAG -> AAGTACCACCACCCCAAGC
TCGGAAATAGGAGTTCTGA -> CGGAAATAGGAGTTCTGAG
GACTAGGGTTGCTCCGGAC -> ACTAGGGTTGCTCCGGACT
TCTTGTTACATTGAGGGCT -> CTTGTTACATTGAGGGCTT
TCCCGCTCATGTGTCCCTC -> CCCGCTCATGTGTCCCTCT
CTCTCCGGGAATGAAATAA -> TCTCCGGGAATGAAATAAG
GAACGTATTGGCAAAAATC -> AACGTATTGGCAAAAATCG
TCAGGATTATGTTTATTAC -> CAGGATTATGTTTATTACC
GACTGTGCAATTTCAATCT -> ACTGTGCAATTTCAATCTT
AACGTGACGCATTTTTAGT -> ACGTGACGCATTTTTAGTC
GCGGTGCCCGCACTCCCGT -> CGGTGCCCGCACTCCCGTT
TCGTTAAACCTTGTCCTTC -> CGTTAAACCTTGTCCTTCT
CGATCTTCCTGTTCCTTAT -> GATCTTCCTGTTCCTTATG
GTTTCTGTTGGTAGCTATA -> TTTCTGTTGGTAGCTATAG
GATCCTATCACCGGTATAG -> ATCCTATCACCGGTATAGC
TTAAAGTCTATTCTATCCT -> TAAAGTCTATTCTATCCTC
ATTATGTTTATTACCGGGT -> TTATGTTTATTACCGGGTT
GGACTCCCGTTCTTGTTAC -> GACTCCCGTTCTTGTTACA
GTAGTAGGCAAACCTTCAA -> TAGTAGGCAAACCTTCAAA
ATATTGGTATACATATACC -> TATTGGTATACATATACCG
GACGGCGTAGGGAATTGTG -> ACGGCGTAGGGAATTGTGA
ACAGCACGGCGCATTAATG -> CAGCACGGCGCATTAATGG
CGTTCCGTATGATCCATTA -> GTTCCGTATGATCCATTAA
ACCTCAGCTTGCACGGACA -> CCTCAGCTTGCACGGACAC
TGATGGCTCCGCAGTGCTC -> GATGGCTCCGCAGTGCTCC
AACATTAGCTTGGGCCTGC -> ACATTAGCTTGGGCCTGCT
TCTCGATGGAGCAACAGGG -> CTCGATGGAGCAACAGGGT
CACCCCAAGCTCGCCCTAT -> ACCCCAAGCTCGCCCTATC
GATAACAAGGTGCCCGTCA -> ATAACAAGGTGCCCGTCAT
GTGGCGTGTTCCCAGCGTG -> TGGCGTGTTCCCAGCGTGT
GTCAGGTCTGCCATTTACC -> TCAGGTCTGCCATTTACCA
ATTTTGGTCGAAAAGAATT -> TTTTGGTCGAAAAGAATTA
GTCAGTACAATTGGGCTGT -> TCAGTACAATTGGGCTGTA
CGGACGGATCTCATCACCT -> GGACGGATCTCATCACCTC
ATAAATCAGCAACTGGTGC -> TAAATCAGCAACTGGTGCC
CCAAGCTTCAGGTGACAAT -> CAAGCTTCAGGTGACAATG
ATTAGTGCATCAGGATTAT -> TTAGTGCATCAGGATTATG
ACCATCTTGCCCCACCGCC -> CCATCTTGCCCCACCGCCG
AGATCCTGTGATAAACTTC -> GATCCTGTGATAAACTTCG
ATAGCCTGTGAGCTGTGCC -> TAGCCTGTGAGCTGTGCCC
GATTATGTTTATTACCGGG -> ATTATGTTTATTACCGGGT
GAGATTGGAGCATGGACTT -> AGATTGGAGCATGGACTTC
CTATCCTCGTTTTGTCGGA -> TATCCTCGTTTTGTCGGAG
CGTTTTGTCGGAGGAGTCC -> GTTTTGTCGGAGGAGTCCG
GGGGTCGTGCACGAAGTCA -> GGGTCGTGCACGAAGTCAA
AAGACTAGGGTTGCTCCGG -> AGACTAGGGTTGCTCCGGA
CAGTAGATGGAGTGCCGAA -> AGTAGATGGAGTGCCGAAT
TAGAGCCAAGCTTCAGGTG -> AGAGCCAAGCTTCAGGTGA
TGGAACGGGCCGCTGAGAC -> GGAACGGGCCGCTGAGACC
AAGCTAGGAACACCAACAA -> AGCTAGGAACACCAACAAT
ACATTAGCTTGGGCCTGCT -> CATTAGCTTGGGCCTGCTT
ATCACCTCAGCTTGCACGG -> TCACCTCAGCTTGCACGGA
CTTCCGTAAGCTAGGAACA -> TTCCGTAAGCTAGGAACAC
GTATACATATACCGTGGGT -> TATACATATACCGTGGGTC
GGTGATTCGTCCTACATCC -> GTGATTCGTCCTACATCCT
GCTATACACCGTGAATAAA -> CTATACACCGTGAATAAAC
CCTTATGGTTCGCCAGAGC -> CTTATGGTTCGCCAGAGCT
GACCCAACTACGCACGTCC -> ACCCAACTACGCACGTCCC
GGAGACCTAGGTGGTATGT -> GAGACCTAGGTGGTATGTG
TCTTGCCCCACCGCCGGTG -> CTTGCCCCACCGCCGGTGA
TGAAATAAGACTAGGTTGC -> GAAATAAGACTAGGTTGCC
TGAGCTGTGCCCTGGAACC -> GAGCTGTGCCCTGGAACCC
CAGGTAGAGATTGGAGCAT -> AGGTAGAGATTGGAGCATG
TGGTCGAAAAGAATTATCC -> GGTCGAAAAGAATTATCCA
AGGTGGATATGTCAAATTA -> GGTGGATATGTCAAATTAT
CGCAGTTTCTGTTGGTAGC -> GCAGTTTCTGTTGGTAGCT
TAGAGATTGGAGCATGGAC -> AGAGATTGGAGCATGGACT
CATACATGGCTCTGACGAT -> ATACATGGCTCTGACGATG
CTGTTCCTTATGGTTCGCC -> TGTTCCTTATGGTTCGCCA
CAGAGCTCAGTTACGGGTG -> AGAGCTCAGTTACGGGTGC
ATAGGAGTTCTGAGAGGTC -> TAGGAGTTCTGAGAGGTCG
ACCCATTACGGATAACAAG -> CCCATTACGGATAACAAGG
ATCATGCAGCATCTCCCCT -> TCATGCAGCATCTCCCCTT
ATATAATACTACAGGTCAC -> TATAATACTACAGGTCACA
TGACGCATTTTTAGTCCGT -> GACGCATTTTTAGTCCGTT
GGTCTCGATGGAGCAACAG -> GTCTCGATGGAGCAACAGG
ATAAATGCAACAAGTAGGT -> TAAATGCAACAAGTAGGTG
ACGCTGTTTCTTCCCATTG -> CGCTGTTTCTTCCCATTGG
TCTGTTGGTAGCTATAGAG -> CTGTTGGTAGCTATAGAGT
ACAGCATAACAAGACGGCG -> CAGCATAACAAGACGGCGT
ATCATGATCGTATAAATGC -> TCATGATCGTATAAATGCA
CTGAGCGCATACCCCGCTA -> TGAGCGCATACCCCGCTAA
TGCGGCCTCCCGTTCTTGT -> GCGGCCTCCCGTTCTTGTT
AGAGCTCAGTTACGGGTGC -> GAGCTCAGTTACGGGTGCG
GAATGTCGGGTGAAGCGAA -> AATGTCGGGTGAAGCGAAG
TCTATTAGTGCATCAGGAT -> CTATTAGTGCATCAGGATT
TATCCTCGTTTTGTCGGAG -> ATCCTCGTTTTGTCGGAGG
GGGGGGTCGTGCACGAAGT -> GGGGGTCGTGCACGAAGTC
CATATACCGTGGGTCAGTA -> ATATACCGTGGGTCAGTAC
AACCCTTCCTGTTCCAAGC -> ACCCTTCCTGTTCCAAGCG
AGCACTGTATAGTAGCTAC -> GCACTGTATAGTAGCTACT
ACAAGGTGCCCGTCATTCT -> CAAGGTGCCCGTCATTCTG
AAACCACACCCGACATGGG -> AACCACACCCGACATGGGC
CATTGTGGAACCCTTCCTG -> ATTGTGGAACCCTTCCTGT
TCTTGGGGACAGATTTTGG -> CTTGGGGACAGATTTTGGT
CCATTACGGATAACAAGGT -> CATTACGGATAACAAGGTG
TACCCATTACGGATAACAA -> ACCCATTACGGATAACAAG
CTGCCATTTACCATATGCG -> TGCCATTTACCATATGCGA
GTCTGCCATTTACCATATG -> TCTGCCATTTACCATATGC
GTGCCCGTCATTCTGTTAG -> TGCCCGTCATTCTGTTAGG
GCATCTCCCCTTCTCCGTT -> CATCTCCCCTTCTCCGTTC
CTAAGAAAGGTGCGTGACT -> TAAGAAAGGTGCGTGACTC
TACATTAGTCAGGTCTGCC -> ACATTAGTCAGGTCTGCCA
CATGCAGCATCTCCCCTTC -> ATGCAGCATCTCCCCTTCT
CTGTATAGTAGCTACTCGC -> TGTATAGTAGCTACTCGCA
TTTGTGCGGCCTCCCGTTC -> TTGTGCGGCCTCCCGTTCT
GCTTGCACGGACACGTCAT -> CTTGCACGGACACGTCATA
AACGAATAGCATGAGGTCA -> ACGAATAGCATGAGGTCAG
GTGGTATGTGGCGTGTTCC -> TGGTATGTGGCGTGTTCCC
AATTAGCAGTGTATAACCA -> ATTAGCAGTGTATAACCAA
ATTATCTGCATTGTGGAAC -> TTATCTGCATTGTGGAACC
TATTGGTATACATATACCG -> ATTGGTATACATATACCGT
TTGAGGGCTTAGCAACCAT -> TGAGGGCTTAGCAACCATC
CAGGTCACAGCACTGTATA -> AGGTCACAGCACTGTATAG
GGAACACCAACAATTTGCC -> GAACACCAACAATTTGCCC
ATCTCCCCTTCTCCGTTCA -> TCTCCCCTTCTCCGTTCAA
GTGGGTGGGACTTAGGGCT -> TGGGTGGGACTTAGGGCTC
AAGCTTCAGGTGACAATGT -> AGCTTCAGGTGACAATGTC
GCACGTCCCCTTCGACTAG -> CACGTCCCCTTCGACTAGT
TCCAAGCGTGTGGAGAGCC -> CCAAGCGTGTGGAGAGCCT
GCATGGAACGAATGAAATA -> CATGGAACGAATGAAATAA
CCGTAGAAACTACGTGTCT -> CGTAGAAACTACGTGTCTA
GTCCCTCTCGTATATTGGT -> TCCCTCTCGTATATTGGTA
GTGCACAAACCGGGGGGGA -> TGCACAAACCGGGGGGGAA
GGCGTAGGGAATTGTGAAA -> GCGTAGGGAATTGTGAAAT
ATTGGAAAAACTGATGTTG -> TTGGAAAAACTGATGTTGT
TCCTTCTGTCGTAAACAGC -> CCTTCTGTCGTAAACAGCA
TATTGGCAAAAATCGATAT -> ATTGGCAAAAATCGATATA
TGTACTGCAATCGGGGGGC -> GTACTGCAATCGGGGGGCT
CCTGTTCCTTATGGTTCGC -> CTGTTCCTTATGGTTCGCC
AACCCTCACTACAACATTA -> ACCCTCACTACAACATTAG
GCCAAGCTTCAGGTGACAA -> CCAAGCTTCAGGTGACAAT
ACGGTTCATCTACGATCTT -> CGGTTCATCTACGATCTTC
GTCCTTCTGTCGTAAACAG -> TCCTTCTGTCGTAAACAGC
GAGTTACCATAAAGTTCTT -> AGTTACCATAAAGTTCTTC
TTCAGGTGACAATGTCCCG -> TCAGGTGACAATGTCCCGC
CCGACATGGGCTTAATTTA -> CGACATGGGCTTAATTTAG
GGACACGTCATACGTATGT -> GACACGTCATACGTATGTC
TTAGCAGTGTATAACCAAA -> TAGCAGTGTATAACCAAAG
AATGCAACAAGTAGGTGGA -> ATGCAACAAGTAGGTGGAT
TGGCAGCGAGAACGTATTG -> GGCAGCGAGAACGTATTGG
GGTCACAGCACTGTATAGT -> GTCACAGCACTGTATAGTA
TTTTGGTCGAAAAGAATTA -> TTTGGTCGAAAAGAATTAT
GCGAAGAATATGGTGCATA -> CGAAGAATATGGTGCATAG
AGATTGCTTTCGGAACAAT -> GATTGCTTTCGGAACAATC
AGGGCTCGTAGCGGTCTCG -> GGGCTCGTAGCGGTCTCGA
CGGTCTCGATGGAGCAACA -> GGTCTCGATGGAGCAACAG
CCATTAAAGTCTATTCTAT -> CATTAAAGTCTATTCTATC
TTGTCGGAGGAGTCCGGGA -> TGTCGGAGGAGTCCGGGAG
TACCGTGGGTCAGTACAAT -> ACCGTGGGTCAGTACAATT
TGTCGTTAAACCTTGTCCT -> GTCGTTAAACCTTGTCCTT
AACAGCATAACAAGACGGC -> ACAGCATAACAAGACGGCG
AAATTATCTGCATTGTGGA -> AATTATCTGCATTGTGGAA
CGCTAAGAAAGGTGCGTGA -> GCTAAGAAAGGTGCGTGAC
GGGGGGCTTCGCGCACTAC -> GGGGGCTTCGCGCACTACC
GAGCTGTGCCCTGGAACCC -> AGCTGTGCCCTGGAACCCT
CAACAATTTGCCCCTCTCC -> AACAATTTGCCCCTCTCCG
CGTAGAAACTACGTGTCTA -> GTAGAAACTACGTGTCTAG
AAAATCGATATAATACTAC -> AAATCGATATAATACTACA
ATTGGGCTGTATTGATGGC -> TTGGGCTGTATTGATGGCT
CGACCGACACGTGGTTGGC -> GACCGACACGTGGTTGGCA
CTGTTGGTAGCTATAGAGT -> TGTTGGTAGCTATAGAGTG
GCCCCTCTCCGGGAATGAA -> CCCCTCTCCGGGAATGAAA
AGCATGAGGTCAGTCGTAC -> GCATGAGGTCAGTCGTACC
GGGCTTCGCGCACTACCCA -> GGCTTCGCGCACTACCCAT
CTTCTGTCGTAAACAGCAC -> TTCTGTCGTAAACAGCACG
CTAGTGCGGTGGAACGGGC -> TAGTGCGGTGGAACGGGCC
CTAGGATTTGTGCGGCCTC -> TAGGATTTGTGCGGCCTCC
TGGACTTCACTTCAAGGAG -> GGACTTCACTTCAAGGAGT
CTCGTATATTGGTATACAT -> TCGTATATTGGTATACATA
TAGGCGGTGCCCGCACTCC -> AGGCGGTGCCCGCACTCCC
CACCTCAGCTTGCACGGAC -> ACCTCAGCTTGCACGGACA
ACGAAGTCAAGATCTAGAG -> CGAAGTCAAGATCTAGAGC
CAACATTAGCTTGGGCCTG -> AACATTAGCTTGGGCCTGC
AGGTCACAGCACTGTATAG -> GGTCACAGCACTGTATAGT
GAAAAACTGATGTTGTCAC -> AAAAACTGATGTTGTCACG
TCCTTATGGTTCGCCAGAG -> CCTTATGGTTCGCCAGAGC
GACTAGTGCGGTGGAACGG -> ACTAGTGCGGTGGAACGGG
CGTCGTCACTACTTTCATA -> GTCGTCACTACTTTCATAC
CGCCTCTGCGCAGATTGCT -> GCCTCTGCGCAGATTGCTT
TTCCCAGCGTGTTCAAAGC -> TCCCAGCGTGTTCAAAGCG
ACACCAACAATTTGCCCCT -> CACCAACAATTTGCCCCTC
AGTACAATTGGGCTGTATT -> GTACAATTGGGCTGTATTG
CTGGTCGAATTAGCAGTGT -> TGGTCGAATTAGCAGTGTA
TTCATCTACGATCTTCCTG -> TCATCTACGATCTTCCTGT
AATGAAATAAGACTAGGAT -> ATGAAATAAGACTAGGATT
AATTGGGCTGTATTGATGG -> ATTGGGCTGTATTGATGGC
GTCGGATCAACCTTCCGTA -> TCGGATCAACCTTCCGTAA
CCTCTCCGGGAATGAAATA -> CTCTCCGGGAATGAAATAA
GTATAACCAAAGTAACAGC -> TATAACCAAAGTAACAGCA
GGGGGGAACGCAATTAGGG -> GGGGGAACGCAATTAGGGA
AGTAGCTACTCGCAGTAGA -> GTAGCTACTCGCAGTAGAT
AGATCTAGAGCCAAGCTTC -> GATCTAGAGCCAAGCTTCA
TCGTATAAATGCAACAAGT -> CGTATAAATGCAACAAGTA
GTGGTTGGCAGCGAGAACG -> TGGTTGGCAGCGAGAACGT
GTATGATCCATTAAAGTCT -> TATGATCCATTAAAGTCTA
TGAGCGCATACCCCGCTAA -> GAGCGCATACCCCGCTAAG
GCACTACTATTGGGTGACG -> CACTACTATTGGGTGACGG
CCTAGCCAGACGCTGTTTC -> CTAGCCAGACGCTGTTTCT
AGCGCATACCCCGCTAAGA -> GCGCATACCCCGCTAAGAA
TTGGTATACATATACCGTG -> TGGTATACATATACCGTGG
ACGGGGATCCTATCACCGG -> CGGGGATCCTATCACCGGT
AGGTGACAATGTCCCGCTC -> GGTGACAATGTCCCGCTCA
ATCTTGCCCCACCGCCGGT -> TCTTGCCCCACCGCCGGTG
TGTGATAAACTTCGTCCAA -> GTGATAAACTTCGTCCAAA
GCGTGTTCAAAGCGACCGA -> CGTGTTCAAAGCGACCGAC
TCTGCCATTTACCATATGC -> CTGCCATTTACCATATGCG
CTATTCTATCCTCGTTTTG -> TATTCTATCCTCGTTTTGT
TTCTTGTTACATTAGTGGC -> TCTTGTTACATTAGTGGCA
GGGCTGTATTGATGGCTCC -> GGCTGTATTGATGGCTCCG
TACTATTGGGTGACGGTTC -> ACTATTGGGTGACGGTTCA
AGCTGTGCCCTGGAACCCT -> GCTGTGCCCTGGAACCCTC
ACCGGCTGATCGCGACTGA -> CCGGCTGATCGCGACTGAG
CCGTAAGCTAGGAACACCA -> CGTAAGCTAGGAACACCAA
TGCATCAGGATTATGTTTA -> GCATCAGGATTATGTTTAT
GTTTATTACCGGGTTTCTG -> TTTATTACCGGGTTTCTGA
TTGGGCAGCTGTGGGTGGG -> TGGGCAGCTGTGGGTGGGA
ACTTAGGGCTCGTAGCGGT -> CTTAGGGCTCGTAGCGGTC
TGTGAGCTGTGCCCTGGAA -> GTGAGCTGTGCCCTGGAAC
GTCAGTCGTACCGTGCCTT -> TCAGTCGTACCGTGCCTTC
GTAGAAACTACGTGTCTAG -> TAGAAACTACGTGTCTAGA
TCCATTAAAGTCTATTCTA -> CCATTAAAGTCTATTCTAT
AGAACGTATTGGCAAAAAT -> GAACGTATTGGCAAAAATC
TAGGAACACCAACAATTTG -> AGGAACACCAACAATTTGC
ATATGGTGCATAGCCTGTG -> TATGGTGCATAGCCTGTGA
GCTCAGTTACGGGTGCGAA -> CTCAGTTACGGGTGCGAAT
CCGTTCTTGTTACATTGAG -> CGTTCTTGTTACATTGAGG
ATCTTGGGGACAGATTTTG -> TCTTGGGGACAGATTTTGG
ACCACCACCCCAAGCTCGC -> CCACCACCCCAAGCTCGCC
GGAGTTCTGAGAGGTCGGG -> GAGTTCTGAGAGGTCGGGG
TCTTGTTACATTAGTGGCA -> CTTGTTACATTAGTGGCAT
CGTTCTTGTTACATTTGAT -> GTTCTTGTTACATTTGATG
AAGGGGCTGTAGTAGGCAA -> AGGGGCTGTAGTAGGCAAA
AAAGAATTATCCAGGTAGA -> AAGAATTATCCAGGTAGAG
TGCAGCACTACTATTGGGT -> GCAGCACTACTATTGGGTG
TGCTTGAACAGTCACAAAC -> GCTTGAACAGTCACAAACG
TCCGTATGATCCATTAAAG -> CCGTATGATCCATTAAAGT
GAACCCTTCCTGTTCCAAG -> AACCCTTCCTGTTCCAAGC
AACTGGTGCCTTCTTACGA -> ACTGGTGCCTTCTTACGAA
AATAGCATGAGGTCAGTCG -> ATAGCATGAGGTCAGTCGT
AACAGTCACAAACGAATAG -> ACAGTCACAAACGAATAGC
CGCACTACCCATTACGGAT -> GCACTACCCATTACGGATA
TAAGTGAATGAAATAAGAC -> AAGTGAATGAAATAAGACT
CACTTCAAGGAGTTACCAT -> ACTTCAAGGAGTTACCATA
GGATTTGTGCGGCCTCCCG -> GATTTGTGCGGCCTCCCGT
ATACGTATGTCGTTAAACC -> TACGTATGTCGTTAAACCT
TCACCGGTATAGCAATTGC -> CACCGGTATAGCAATTGCC
CTGTTTCTTCCCATTGGAA -> TGTTTCTTCCCATTGGAAA
TTGTCACGCGGACGGATCT -> TGTCACGCGGACGGATCTC
TGGAAAAACTGATGTTGTC -> GGAAAAACTGATGTTGTCA
GATCAACCTTCCGTAAGCT -> ATCAACCTTCCGTAAGCTA
TTGATGTGTACTGCAATCG -> TGATGTGTACTGCAATCGG
AGACTAGGCGGTGCCCGCA -> GACTAGGCGGTGCCCGCAC
CTGGTGCCTTCTTACGAAA -> TGGTGCCTTCTTACGAAAA
GGGTTTCTGACTGGTCGGA -> GGTTTCTGACTGGTCGGAT
TGGTATACATATACCGTGG -> GGTATACATATACCGTGGG
AGTCCGGGAGATCCTGTGA -> GTCCGGGAGATCCTGTGAT
AAGAATTATCCAGGTAGAG -> AGAATTATCCAGGTAGAGA
GGGCCTGCTTGAACAGTCA -> GGCCTGCTTGAACAGTCAC
GCCCTGGAACCCTCACTAC -> CCCTGGAACCCTCACTACA
GTAAGCTAGGAACACCAAC -> TAAGCTAGGAACACCAACA
CAGTTACGGGTGCGAATGT -> AGTTACGGGTGCGAATGTC
GAGTGGACCGCTCCGGATG -> AGTGGACCGCTCCGGATGT
ACGCGGACGGATCTCATCA -> CGCGGACGGATCTCATCAC
CAGCGTGTTCAAAGCGACC -> AGCGTGTTCAAAGCGACCG
GCAAAAATCGATATAATAC -> CAAAAATCGATATAATACT
CAGACGCTGTTTCTTCCCA -> AGACGCTGTTTCTTCCCAT
CTTAGGGCTCGTAGCGGTC -> TTAGGGCTCGTAGCGGTCT
CCTAGGTGGTATGTGGCGT -> CTAGGTGGTATGTGGCGTG
GGAACGCAATTAGGGAGAC -> GAACGCAATTAGGGAGACC
AACACCAACAATTTGCCCC -> ACACCAACAATTTGCCCCT
CCCGTTCTTGTTACATTAG -> CCGTTCTTGTTACATTAGT,CCGTTCTTGTTACATTAGT
GTGCATAGCCTGTGAGCTG -> TGCATAGCCTGTGAGCTGT
ACGGATCTCATCACCTCAG -> CGGATCTCATCACCTCAGC
ATTACGGATAACAAGGTGC -> TTACGGATAACAAGGTGCC
CAGTGTATAACCAAAGTAA -> AGTGTATAACCAAAGTAAC
TCAGCAACTGGTGCCTTCT -> CAGCAACTGGTGCCTTCTT
CCCTATCATGCAGCATCTC -> CCTATCATGCAGCATCTCC
TGATGTGTACTGCAATCGG -> GATGTGTACTGCAATCGGG
AATCAGCAACTGGTGCCTT -> ATCAGCAACTGGTGCCTTC
ACATGGGCTTAATTTAGCG -> CATGGGCTTAATTTAGCGG
CGGTGAAGCCAGGAAGTAC -> GGTGAAGCCAGGAAGTACC
TAGGAGATTCACATGTCTG -> AGGAGATTCACATGTCTGG
CCAACGTGACGCATTTTTA -> CAACGTGACGCATTTTTAG
TAGCCAGACGCTGTTTCTT -> AGCCAGACGCTGTTTCTTC
TCACATGTCTGGCTGCACG -> CACATGTCTGGCTGCACGT
AATCGATATAATACTACAG -> ATCGATATAATACTACAGG
GAATTATCCAGGTAGAGAT -> AATTATCCAGGTAGAGATT
TCTGCATTGTGGAACCCTT -> CTGCATTGTGGAACCCTTC
ACGTCATACGTATGTCGTT -> CGTCATACGTATGTCGTTA
AGTCCGTTCCGTATGATCC -> GTCCGTTCCGTATGATCCA
CCCCTTCTCCGTTCAAACC -> CCCTTCTCCGTTCAAACCA
CACCGTGAATAAACCGGCT -> ACCGTGAATAAACCGGCTG
GTATACGACTTCACGGGGA -> TATACGACTTCACGGGGAT
CGAATGTCGGGTGAAGCGA -> GAATGTCGGGTGAAGCGAA
ACCGTGCCTTCGCGACCCA -> CCGTGCCTTCGCGACCCAA
GTTACCATAAAGTTCTTCT -> TTACCATAAAGTTCTTCTG
TCTTCCTGTTCCTTATGGT -> CTTCCTGTTCCTTATGGTT
GCAGTTTCTGTTGGTAGCT -> CAGTTTCTGTTGGTAGCTA
ACTTCGTCCAAAAAGGGGC -> CTTCGTCCAAAAAGGGGCT
TGTCCCTCTCGTATATTGG -> GTCCCTCTCGTATATTGGT
ATTAATGGTCGCCTCTGCG -> TTAATGGTCGCCTCTGCGC
CCCACCGCCGGTGAAGCCA -> CCACCGCCGGTGAAGCCAG
TTCAAAATAAATCAGCAAC -> TCAAAATAAATCAGCAACT
TAGTCCGTTCCGTATGATC -> AGTCCGTTCCGTATGATCC
TTACGGATAACAAGGTGCC -> TACGGATAACAAGGTGCCC
GAGAACGTATTGGCAAAAA -> AGAACGTATTGGCAAAAAT
ACCTTCCGTAAGCTAGGAA -> CCTTCCGTAAGCTAGGAAC
GTTACATTGAGGGCTTAGC -> TTACATTGAGGGCTTAGCA
GTACTGCAATCGGGGGGCT -> TACTGCAATCGGGGGGCTT
TTCGGAAATAGGAGTTCTG -> TCGGAAATAGGAGTTCTGA
CGGATCAACCTTCCGTAAG -> GGATCAACCTTCCGTAAGC
AGTTCTGAGAGGTCGGGGG -> GTTCTGAGAGGTCGGGGGG
ATGTTTATTACCGGGTTTC -> TGTTTATTACCGGGTTTCT
ACTAGTGCGGTGGAACGGG -> CTAGTGCGGTGGAACGGGC
TGTTACATTGAGGGCTTAG -> GTTACATTGAGGGCTTAGC
GGAAGTACCACCACCCCAA -> GAAGTACCACCACCCCAAG
CTTCGCGCACTACCCATTA -> TTCGCGCACTACCCATTAC
TTATCTGCATTGTGGAACC -> TATCTGCATTGTGGAACCC
TAGCAATTGCCATAGTCGG -> AGCAATTGCCATAGTCGGT
AACGAATGAAATAAGACTA -> ACGAATGAAATAAGACTAG
CCTGGAACCCTCACTACAA -> CTGGAACCCTCACTACAAC
TTAGTGCATCAGGATTATG -> TAGTGCATCAGGATTATGT
TAAGACTAGGCGGTGCCCG -> AAGACTAGGCGGTGCCCGC
GGACGGATCTCATCACCTC -> GACGGATCTCATCACCTCA
GTGCATCAGGATTATGTTT -> TGCATCAGGATTATGTTTA
AAAAACTGATGTTGTCACG -> AAAACTGATGTTGTCACGC
TGGGTCAGTACAATTGGGC -> GGGTCAGTACAATTGGGCT
AGTGCATCAGGATTATGTT -> GTGCATCAGGATTATGTTT
CCGGGAGATCCTGTGATAA -> CGGGAGATCCTGTGATAAA
GAAGCGAAGAATATGGTGC -> AAGCGAAGAATATGGTGCA
GTCGCCTCTGCGCAGATTG -> TCGCCTCTGCGCAGATTGC
GTCTGGCTGCACGTGCTAT -> TCTGGCTGCACGTGCTATA
TGATAAACTTCGTCCAAAA -> GATAAACTTCGTCCAAAAA
GGTTCATCTACGATCTTCC -> GTTCATCTACGATCTTCCT
TGGAGCATGGACTTCACTT -> GGAGCATGGACTTCACTTC
CTTGCCCCACCGCCGGTGA -> TTGCCCCACCGCCGGTGAA
TAACAAGGTGCCCGTCATT -> AACAAGGTGCCCGTCATTC
ACAATTTGCCCCTCTCCGG -> CAATTTGCCCCTCTCCGGG
CAACGTGACGCATTTTTAG -> AACGTGACGCATTTTTAGT
ATCGATATAATACTACAGG -> TCGATATAATACTACAGGT
CAACCATCTTGCCCCACCG -> AACCATCTTGCCCCACCGC
AAGTCAAGATCTAGAGCCA -> AGTCAAGATCTAGAGCCAA
CAATGCTAAGATTAGTTCG -> AATGCTAAGATTAGTTCGG
GGAACGAATGAAATAAGAC -> GAACGAATGAAATAAGACT
TAGGTGGTATGTGGCGTGT -> AGGTGGTATGTGGCGTGTT
TGAATAAACCGGCTGATCG -> GAATAAACCGGCTGATCGC
TGACTGTGCAATTTCAATC -> GACTGTGCAATTTCAATCT
TCTCCCCTTCTCCGTTCAA -> CTCCCCTTCTCCGTTCAAA
ACCACACCCGACATGGGCT -> CCACACCCGACATGGGCTT
AGTACCACCACCCCAAGCT -> GTACCACCACCCCAAGCTC
CACTACTTTCATACATGGC -> ACTACTTTCATACATGGCT
AGCATGGACTTCACTTCAA -> GCATGGACTTCACTTCAAG
TTTAGTCCGTTCCGTATGA -> TTAGTCCGTTCCGTATGAT
TACAACATTAGCTTGGGCC -> ACAACATTAGCTTGGGCCT
CTCCGGATGTTGCAGCACT -> TCCGGATGTTGCAGCACTA
TTCGCATGGAACGAATGAA -> TCGCATGGAACGAATGAAA
ATGGAGCAACAGGGTGCAC -> TGGAGCAACAGGGTGCACA
ATGGTGCATAGCCTGTGAG -> TGGTGCATAGCCTGTGAGC
TGTTACATTTGATGTGTAC -> GTTACATTTGATGTGTACT
ATGATCGTATAAATGCAAC -> TGATCGTATAAATGCAACA
AGTAGATGGAGTGCCGAAT -> GTAGATGGAGTGCCGAATG
CCACCACCCCAAGCTCGCC -> CACCACCCCAAGCTCGCCC
GGACTTCACTTCAAGGAGT -> GACTTCACTTCAAGGAGTT
TGGCATAGGAGATTCACAT -> GGCATAGGAGATTCACATG
TCAATCTTGGGGACAGATT -> CAATCTTGGGGACAGATTT
ATCTATTAGTGCATCAGGA -> TCTATTAGTGCATCAGGAT
ATTGGTATACATATACCGT -> TTGGTATACATATACCGTG
CATGACTGTGCAATTTCAA -> ATGACTGTGCAATTTCAAT
GAATGAAATAAGACTAGGT -> AATGAAATAAGACTAGGTT
TCGCCCTATCATGCAGCAT -> CGCCCTATCATGCAGCATC
GCCTCCCGTTCTTGTTACA -> CCTCCCGTTCTTGTTACAT
GCAATCGGGGGGCTTCGCG -> CAATCGGGGGGCTTCGCGC
ATAGAGTGGACCGCTCCGG -> TAGAGTGGACCGCTCCGGA
GGATCTCATCACCTCAGCT -> GATCTCATCACCTCAGCTT
TCGTATATTGGTATACATA -> CGTATATTGGTATACATAT
AGCCTAGCCAGACGCTGTT -> GCCTAGCCAGACGCTGTTT
CGGAAATAGGAGTTCTGAG -> GGAAATAGGAGTTCTGAGA
CCTTCGACTAGTGCGGTGG -> CTTCGACTAGTGCGGTGGA
CGCATGGAACGAATGAAAT -> GCATGGAACGAATGAAATA
GATTTTGGTCGAAAAGAAT -> ATTTTGGTCGAAAAGAATT
GTGCCCGCACTCCCGTTCT -> TGCCCGCACTCCCGTTCTT
CCCGCTAAGAAAGGTGCGT -> CCGCTAAGAAAGGTGCGTG
ACGTCGTCACTACTTTCAT -> CGTCGTCACTACTTTCATA
GTAAACAGCACGGCGCATT -> TAAACAGCACGGCGCATTA
ATAAGACTAGGATTTGTGC -> TAAGACTAGGATTTGTGCG
TCCGTAAGCTAGGAACACC -> CCGTAAGCTAGGAACACCA
CTATTAGTGCATCAGGATT -> TATTAGTGCATCAGGATTA
TGCCATTTACCATATGCGA -> GCCATTTACCATATGCGAA
CCTTCCTGTTCCAAGCGTG -> CTTCCTGTTCCAAGCGTGT
TTAGTTCGGAAATAGGAGT -> TAGTTCGGAAATAGGAGTT
GAAAAAATCATGATCGTAT -> AAAAAATCATGATCGTATA
GAACGGGCCGCTGAGACCA -> AACGGGCCGCTGAGACCAG
GAGCCAAGCTTCAGGTGAC -> AGCCAAGCTTCAGGTGACA
TCAAGGAGTTACCATAAAG -> CAAGGAGTTACCATAAAGT
CAATTGCCATAGTCGGTGA -> AATTGCCATAGTCGGTGAT
GCCATTTACCATATGCGAA -> CCATTTACCATATGCGAAA
CCTAATACAGTGTCTATAC -> CTAATACAGTGTCTATACG
GTTGCTCCGGACTCCCGTT -> TTGCTCCGGACTCCCGTTC
ATGAAATAAGACTAGGATT -> TGAAATAAGACTAGGATTT
CTTGAACAGTCACAAACGA -> TTGAACAGTCACAAACGAA
CTGATCGCGACTGAGCGCA -> TGATCGCGACTGAGCGCAT
AAGACTAGGCGGTGCCCGC -> AGACTAGGCGGTGCCCGCA
TCTCCCGTTCTTGTTACAT -> CTCCCGTTCTTGTTACATT
TAAACCTTGTCCTTCTGTC -> AAACCTTGTCCTTCTGTCG
TACATTTGATGTGTACTGC -> ACATTTGATGTGTACTGCA
CATGTCTGGCTGCACGTGC -> ATGTCTGGCTGCACGTGCT
GTGTTCAAAGCGACCGACA -> TGTTCAAAGCGACCGACAC
AGTAGGCAAACCTTCAAAA -> GTAGGCAAACCTTCAAAAT
GGGACTTAGGGCTCGTAGC -> GGACTTAGGGCTCGTAGCG
GTTCGGAAATAGGAGTTCT -> TTCGGAAATAGGAGTTCTG
ATGAAATAAGACTAGGTTG -> TGAAATAAGACTAGGTTGC
AAATAAATCAGCAACTGGT -> AATAAATCAGCAACTGGTG
TAAGACTAGGATTTGTGCG -> AAGACTAGGATTTGTGCGG
CCACACCCGACATGGGCTT -> CACACCCGACATGGGCTTA
GATATAATACTACAGGTCA -> ATATAATACTACAGGTCAC
AGCTATAGAGTGGACCGCT -> GCTATAGAGTGGACCGCTC
AGGGAGACCTAGGTGGTAT -> GGGAGACCTAGGTGGTATG
GGGGACAGATTTTGGTCGA -> GGGACAGATTTTGGTCGAA
GAACAGTCACAAACGAATA -> AACAGTCACAAACGAATAG
CGACTAGTGCGGTGGAACG -> GACTAGTGCGGTGGAACGG
AGACCAGAATGAAATAAGA -> GACCAGAATGAAATAAGAC
CCTTGTCCTTCTGTCGTAA -> CTTGTCCTTCTGTCGTAAA
GACAATGTCCCGCTCATGT -> ACAATGTCCCGCTCATGTG
TCAGTTACGGGTGCGAATG -> CAGTTACGGGTGCGAATGT
ATTTTTAGTCCGTTCCGTA -> TTTTTAGTCCGTTCCGTAT
CATATGCGAAAACAGAAAA -> ATATGCGAAAACAGAAAAT
TGAACAGTCACAAACGAAT -> GAACAGTCACAAACGAATA
GATCCATGACTGTGCAATT -> ATCCATGACTGTGCAATTT
CTTGTTACATTAGTCAGGT -> TTGTTACATTAGTCAGGTC
TTACATTAGTCAGGTCTGC -> TACATTAGTCAGGTCTGCC
TTACGAAAAAATCATGATC -> TACGAAAAAATCATGATCG
TGAAGCCAGGAAGTACCAC -> GAAGCCAGGAAGTACCACC
ACTTCACGGGGATCCTATC -> CTTCACGGGGATCCTATCA
ATCCATTAAAGTCTATTCT -> TCCATTAAAGTCTATTCTA
TCTTACGAAAAAATCATGA -> CTTACGAAAAAATCATGAT
TGAATGAAATAAGACTAGG -> GAATGAAATAAGACTAGGT
TCTGCGCAGATTGCTTTCG -> CTGCGCAGATTGCTTTCGG
AGCCAAGCTTCAGGTGACA -> GCCAAGCTTCAGGTGACAA
AGGTGGTATGTGGCGTGTT -> GGTGGTATGTGGCGTGTTC
CAGCTTGCACGGACACGTC -> AGCTTGCACGGACACGTCA
CTTTCATACATGGCTCTGA -> TTTCATACATGGCTCTGAC
GACAGATTTTGGTCGAAAA -> ACAGATTTTGGTCGAAAAG
GACTTAGGGCTCGTAGCGG -> ACTTAGGGCTCGTAGCGGT
GGGGGTCGTGCACGAAGTC -> GGGGTCGTGCACGAAGTCA
AGCCAGACGCTGTTTCTTC -> GCCAGACGCTGTTTCTTCC
TCGCCAGACGGTAAGTGAA -> CGCCAGACGGTAAGTGAAT
CAAAATAAATCAGCAACTG -> AAAATAAATCAGCAACTGG
AGACGCTGTTTCTTCCCAT -> GACGCTGTTTCTTCCCATT
ATCCTATCACCGGTATAGC -> TCCTATCACCGGTATAGCA
CTTCAGGTGACAATGTCCC -> TTCAGGTGACAATGTCCCG
GTTCGCCAGAGCTCAGTTA -> TTCGCCAGAGCTCAGTTAC
GCACAAACCGGGGGGGAAC -> CACAAACCGGGGGGGAACG
TGCAGCATCTCCCCTTCTC -> GCAGCATCTCCCCTTCTCC
CCAGAATGAAATAAGACTA -> CAGAATGAAATAAGACTAG
ATTTGATGTGTACTGCAAT -> TTTGATGTGTACTGCAATC
AACAATTTGCCCCTCTCCG -> ACAATTTGCCCCTCTCCGG
CCATGACTGTGCAATTTCA -> CATGACTGTGCAATTTCAA
CGTCCAAAAAGGGGCTGTA -> GTCCAAAAAGGGGCTGTAG
AATGGTCGCCTCTGCGCAG -> ATGGTCGCCTCTGCGCAGA
GTTGCCTGCGGTCTCCCGT -> TTGCCTGCGGTCTCCCGTT
GAAAACAGAAAATTCGGCT -> AAAACAGAAAATTCGGCTT
AGCGACCGACACGTGGTTG -> GCGACCGACACGTGGTTGG
CTACAGGTCACAGCACTGT -> TACAGGTCACAGCACTGTA
ATGAACCAATGCTAAGATT -> TGAACCAATGCTAAGATTA
CGCTCATGTGTCCCTCTCG -> GCTCATGTGTCCCTCTCGT
GCATGAGGTCAGTCGTACC -> CATGAGGTCAGTCGTACCG
GCTATAGAGTGGACCGCTC -> CTATAGAGTGGACCGCTCC
ATGTCCCGCTCATGTGTCC -> TGTCCCGCTCATGTGTCCC
CCGCCAACGTGACGCATTT -> CGCCAACGTGACGCATTTT
ATGTGGCGTGTTCCCAGCG -> TGTGGCGTGTTCCCAGCGT
CTGCAATCGGGGGGCTTCG -> TGCAATCGGGGGGCTTCGC
CTATACGGACAATCTAATA -> TATACGGACAATCTAATAT
AAAAGAATTATCCAGGTAG -> AAAGAATTATCCAGGTAGA
GACGCTGTTTCTTCCCATT -> ACGCTGTTTCTTCCCATTG
TAATATCGATCCATGACTG -> AATATCGATCCATGACTGT
TCTGACTGGTCGGATCAAC -> CTGACTGGTCGGATCAACC
GAGTTCTGAGAGGTCGGGG -> AGTTCTGAGAGGTCGGGGG
CCAGCGTGTTCAAAGCGAC -> CAGCGTGTTCAAAGCGACC
GGGAACGCAATTAGGGAGA -> GGAACGCAATTAGGGAGAC
TTCAATCTTGGGGACAGAT -> TCAATCTTGGGGACAGATT
GCCCTATCATGCAGCATCT -> CCCTATCATGCAGCATCTC
GCTCTGACGATGGTATTGG -> CTCTGACGATGGTATTGGG
TCGTACCGTGCCTTCGCGA -> CGTACCGTGCCTTCGCGAC
TCCTGTGATAAACTTCGTC -> CCTGTGATAAACTTCGTCC
ACGGACACGTCATACGTAT -> CGGACACGTCATACGTATG
CCTATCACCGGTATAGCAA -> CTATCACCGGTATAGCAAT
CGCAATTAGGGAGACCTAG -> GCAATTAGGGAGACCTAGG
ACGTGCTATACACCGTGAA -> CGTGCTATACACCGTGAAT
TCCCTCTCGTATATTGGTA -> CCCTCTCGTATATTGGTAT
TTCGACTAGTGCGGTGGAA -> TCGACTAGTGCGGTGGAAC
CGGCTAAATCGCCAGACGG -> GGCTAAATCGCCAGACGGT
ACGATGGTATTGGGCAGCT -> CGATGGTATTGGGCAGCTG
GGCTTAGCAACCATCTTGC -> GCTTAGCAACCATCTTGCC
ACTACCCATTACGGATAAC -> CTACCCATTACGGATAACA
CGAATTAGCAGTGTATAAC -> GAATTAGCAGTGTATAACC
ATGGTATTGGGCAGCTGTG -> TGGTATTGGGCAGCTGTGG
GAACCAATGCTAAGATTAG -> AACCAATGCTAAGATTAGT
GCTGTGGGTGGGACTTAGG -> CTGTGGGTGGGACTTAGGG
AGTTTCTGTTGGTAGCTAT -> GTTTCTGTTGGTAGCTATA
CGTATAAATGCAACAAGTA -> GTATAAATGCAACAAGTAG
GGAATTGTGAAATGCTTCG -> GAATTGTGAAATGCTTCGC
TATGTGGCGTGTTCCCAGC -> ATGTGGCGTGTTCCCAGCG
ATTAGTTCGGAAATAGGAG -> TTAGTTCGGAAATAGGAGT
CATCACCTCAGCTTGCACG -> ATCACCTCAGCTTGCACGG
AATTGTGAAATGCTTCGCA -> ATTGTGAAATGCTTCGCAT
CATTAGCTTGGGCCTGCTT -> ATTAGCTTGGGCCTGCTTG
GACTGAGCGCATACCCCGC -> ACTGAGCGCATACCCCGCT
AGTCTATTCTATCCTCGTT -> GTCTATTCTATCCTCGTTT
ACTTCAAGGAGTTACCATA -> CTTCAAGGAGTTACCATAA
CGACATGGGCTTAATTTAG -> GACATGGGCTTAATTTAGC
GCTTCAGGTGACAATGTCC -> CTTCAGGTGACAATGTCCC
CTGACTGGTCGGATCAACC -> TGACTGGTCGGATCAACCT
TTACATTAGTGGCATAGGA -> TACATTAGTGGCATAGGAG
CATGGACTTCACTTCAAGG -> ATGGACTTCACTTCAAGGA
TCGATCCATGACTGTGCAA -> CGATCCATGACTGTGCAAT
CACAAACGAATAGCATGAG -> ACAAACGAATAGCATGAGG
AGCTTGGGCCTGCTTGAAC -> GCTTGGGCCTGCTTGAACA
CCTTCTGTCGTAAACAGCA -> CTTCTGTCGTAAACAGCAC
GCGGTGGAACGGGCCGCTG -> CGGTGGAACGGGCCGCTGA
CCTTCAAAATAAATCAGCA -> CTTCAAAATAAATCAGCAA
ATGTCGGGTGAAGCGAAGA -> TGTCGGGTGAAGCGAAGAA
CGTGGTTGGCAGCGAGAAC -> GTGGTTGGCAGCGAGAACG
CCGCTAAGAAAGGTGCGTG -> CGCTAAGAAAGGTGCGTGA
TAGCATGAGGTCAGTCGTA -> AGCATGAGGTCAGTCGTAC
TCCTAATACAGTGTCTATA -> CCTAATACAGTGTCTATAC
CCTATCATGCAGCATCTCC -> CTATCATGCAGCATCTCCC
TCACAGCACTGTATAGTAG -> CACAGCACTGTATAGTAGC
GGTGCGTGACTCTGGCGGA -> GTGCGTGACTCTGGCGGAC
GAGATCCTGTGATAAACTT -> AGATCCTGTGATAAACTTC
ATTGGCAAAAATCGATATA -> TTGGCAAAAATCGATATAA
TGGGCTTAATTTAGCGGCC -> GGGCTTAATTTAGCGGCCG
GCTGATCGCGACTGAGCGC -> CTGATCGCGACTGAGCGCA
CGGCGTAGGGAATTGTGAA -> GGCGTAGGGAATTGTGAAA
GCGGTCTCGATGGAGCAAC -> CGGTCTCGATGGAGCAACA
TCACTACTTTCATACATGG -> CACTACTTTCATACATGGC
AATGTCGGGTGAAGCGAAG -> ATGTCGGGTGAAGCGAAGA
TAAATCAGCAACTGGTGCC -> AAATCAGCAACTGGTGCCT
GGTGCCCGCACTCCCGTTC -> GTGCCCGCACTCCCGTTCT
GCTAAGATTAGTTCGGAAA -> CTAAGATTAGTTCGGAAAT
TTCTTGTTACATTAGTCAG -> TCTTGTTACATTAGTCAGG
CTGAGACCAGAATGAAATA -> TGAGACCAGAATGAAATAA
TTCTGAGAGGTCGGGGGGG -> TCTGAGAGGTCGGGGGGGT
ATTCACATGTCTGGCTGCA -> TTCACATGTCTGGCTGCAC
ACGTCCCCTTCGACTAGTG -> CGTCCCCTTCGACTAGTGC
AGGGTTGCTCCGGACTCCC -> GGGTTGCTCCGGACTCCCG
GTGCAATTTCAATCTTGGG -> TGCAATTTCAATCTTGGGG
CGTGGGTCAGTACAATTGG -> GTGGGTCAGTACAATTGGG
TGCTCCCGTAGAAACTACG -> GCTCCCGTAGAAACTACGT
TTCTCCGTTCAAACCACAC -> TCTCCGTTCAAACCACACC
TATGCGAAAACAGAAAATT -> ATGCGAAAACAGAAAATTC
CTACGCACGTCCCCTTCGA -> TACGCACGTCCCCTTCGAC
TGTGGGTGGGACTTAGGGC -> GTGGGTGGGACTTAGGGCT
TACATTGAGGGCTTAGCAA -> ACATTGAGGGCTTAGCAAC
GGAGAGCCTAGCCAGACGC -> GAGAGCCTAGCCAGACGCT
GATGTTGTCACGCGGACGG -> ATGTTGTCACGCGGACGGA
ACGGGTGCGAATGTCGGGT -> CGGGTGCGAATGTCGGGTG
TTTCATACATGGCTCTGAC -> TTCATACATGGCTCTGACG
GTGCCGAATGAACCAATGC -> TGCCGAATGAACCAATGCT
TGGTAGCTATAGAGTGGAC -> GGTAGCTATAGAGTGGACC
AATATGGTGCATAGCCTGT -> ATATGGTGCATAGCCTGTG
GGTCTCCCGTTCTTGTTAC -> GTCTCCCGTTCTTGTTACA
CATAAAGTTCTTCTGGTCG -> ATAAAGTTCTTCTGGTCGA
GGGGGCTTCGCGCACTACC -> GGGGCTTCGCGCACTACCC
AAACGAATAGCATGAGGTC -> AACGAATAGCATGAGGTCA
CATAACAAGACGGCGTAGG -> ATAACAAGACGGCGTAGGG
ACATTAGTGGCATAGGAGA -> CATTAGTGGCATAGGAGAT
AGCCTGTGAGCTGTGCCCT -> GCCTGTGAGCTGTGCCCTG
ACAATCGGCAGAGATCTAT -> CAATCGGCAGAGATCTATT
ACAATGTCCCGCTCATGTG -> CAATGTCCCGCTCATGTGT
AACCACACCCGACATGGGC -> ACCACACCCGACATGGGCT
TAGCGGCCGCCAACGTGAC -> AGCGGCCGCCAACGTGACG
ATGTGTACTGCAATCGGGG -> TGTGTACTGCAATCGGGGG
CCGGGTTTCTGACTGGTCG -> CGGGTTTCTGACTGGTCGG
CGGCCGCCAACGTGACGCA -> GGCCGCCAACGTGACGCAT
AGATTGGAGCATGGACTTC -> GATTGGAGCATGGACTTCA
GGGTGCGAATGTCGGGTGA -> GGTGCGAATGTCGGGTGAA
GGTGAAGCCAGGAAGTACC -> GTGAAGCCAGGAAGTACCA
ACTACTATTGGGTGACGGT -> CTACTATTGGGTGACGGTT
TCTGGTCGAATTAGCAGTG -> CTGGTCGAATTAGCAGTGT
ATCAGCAACTGGTGCCTTC -> TCAGCAACTGGTGCCTTCT
AAAAAATCATGATCGTATA -> AAAAATCATGATCGTATAA
ACGGCGTAGGGAATTGTGA -> CGGCGTAGGGAATTGTGAA
TTTGATGTGTACTGCAATC -> TTGATGTGTACTGCAATCG
ACCCTCACTACAACATTAG -> CCCTCACTACAACATTAGC
CGGGTTTCTGACTGGTCGG -> GGGTTTCTGACTGGTCGGA
AACCATCTTGCCCCACCGC -> ACCATCTTGCCCCACCGCC
AAGGTGCGTGACTCTGGCG -> AGGTGCGTGACTCTGGCGG
GACACGTGGTTGGCAGCGA -> ACACGTGGTTGGCAGCGAG
TGTCTAGACTCGCAGTTTC -> GTCTAGACTCGCAGTTTCT
CGGCGCATTAATGGTCGCC -> GGCGCATTAATGGTCGCCT
TCGCGCACTACCCATTACG -> CGCGCACTACCCATTACGG
GACTGGTCGGATCAACCTT -> ACTGGTCGGATCAACCTTC
GCAGCTGTGGGTGGGACTT -> CAGCTGTGGGTGGGACTTA
AAGCTCGCCCTATCATGCA -> AGCTCGCCCTATCATGCAG
GGCGGACGGCTAAATCGCC -> GCGGACGGCTAAATCGCCA
GACCTAGGTGGTATGTGGC -> ACCTAGGTGGTATGTGGCG
AATTAGGGAGACCTAGGTG -> ATTAGGGAGACCTAGGTGG
GAATGAAATAAGACTAGGG -> AATGAAATAAGACTAGGGT
TTCTTGTTACATTGAGGGC -> TCTTGTTACATTGAGGGCT
TCCGTTCAAACCACACCCG -> CCGTTCAAACCACACCCGA
CACCCGACATGGGCTTAAT -> ACCCGACATGGGCTTAATT
AAATAAGACTAGGCGGTGC -> AATAAGACTAGGCGGTGCC
GTCGTCACTACTTTCATAC -> TCGTCACTACTTTCATACA
ACTGTATAGTAGCTACTCG -> CTGTATAGTAGCTACTCGC
GAGATCTATTAGTGCATCA -> AGATCTATTAGTGCATCAG
TAGGTATACGACTTCACGG -> AGGTATACGACTTCACGGG
CTCTGGCGGACGGCTAAAT -> TCTGGCGGACGGCTAAATC
ACAATTGGGCTGTATTGAT -> CAATTGGGCTGTATTGATG
AATAAGACTAGGATTTGTG -> ATAAGACTAGGATTTGTGC
CTGGAACCCTCACTACAAC -> TGGAACCCTCACTACAACA
ATGATCCATTAAAGTCTAT -> TGATCCATTAAAGTCTATT
TTAATTTAGCGGCCGCCAA -> TAATTTAGCGGCCGCCAAC
CCTTCTTACGAAAAAATCA -> CTTCTTACGAAAAAATCAT
CGCTGTTTCTTCCCATTGG -> GCTGTTTCTTCCCATTGGA
TCAAATTATCTGCATTGTG -> CAAATTATCTGCATTGTGG
GGGCTGTAGTAGGCAAACC -> GGCTGTAGTAGGCAAACCT
CGTGCCTTCGCGACCCAAC -> GTGCCTTCGCGACCCAACT
ATACCGTGGGTCAGTACAA -> TACCGTGGGTCAGTACAAT
GATCCTGTGATAAACTTCG -> ATCCTGTGATAAACTTCGT
CAATTGGGCTGTATTGATG -> AATTGGGCTGTATTGATGG
AAAAATCGATATAATACTA -> AAAATCGATATAATACTAC
CGTAAGCTAGGAACACCAA -> GTAAGCTAGGAACACCAAC
ATTTACCATATGCGAAAAC -> TTTACCATATGCGAAAACA
ATACATGGCTCTGACGATG -> TACATGGCTCTGACGATGG
TCAGCTTGCACGGACACGT -> CAGCTTGCACGGACACGTC
AATGAACCAATGCTAAGAT -> ATGAACCAATGCTAAGATT
TGTAGTAGGCAAACCTTCA -> GTAGTAGGCAAACCTTCAA
GTGCGGCCTCCCGTTCTTG -> TGCGGCCTCCCGTTCTTGT
ATGGACTTCACTTCAAGGA -> TGGACTTCACTTCAAGGAG
ACCAAAGTAACAGCATAAC -> CCAAAGTAACAGCATAACA
CACCAACAATTTGCCCCTC -> ACCAACAATTTGCCCCTCT
GATTGGAGCATGGACTTCA -> ATTGGAGCATGGACTTCAC
TCTGACGATGGTATTGGGC -> CTGACGATGGTATTGGGCA
GGACGGCTAAATCGCCAGA -> GACGGCTAAATCGCCAGAC
CCAGGAAGTACCACCACCC -> CAGGAAGTACCACCACCCC
AAATCATGATCGTATAAAT -> AATCATGATCGTATAAATG
TGGCGTGTTCCCAGCGTGT -> GGCGTGTTCCCAGCGTGTT
CCTCTCGTATATTGGTATA -> CTCTCGTATATTGGTATAC
GTATAAATGCAACAAGTAG -> TATAAATGCAACAAGTAGG
CACGGACACGTCATACGTA -> ACGGACACGTCATACGTAT
GGTATGTGGCGTGTTCCCA -> GTATGTGGCGTGTTCCCAG
TATTGGGTGACGGTTCATC -> ATTGGGTGACGGTTCATCT
CTTCCCATTGGAAAAACTG -> TTCCCATTGGAAAAACTGA
GGTGGTATGTGGCGTGTTC -> GTGGTATGTGGCGTGTTCC
GAAAAGAATTATCCAGGTA -> AAAAGAATTATCCAGGTAG
GGAACAATCGGCAGAGATC -> GAACAATCGGCAGAGATCT
ATCAACCTTCCGTAAGCTA -> TCAACCTTCCGTAAGCTAG
ACTATTGGGTGACGGTTCA -> CTATTGGGTGACGGTTCAT
GAATGAAATAAGACTAGGA -> AATGAAATAAGACTAGGAT
ACAAACGAATAGCATGAGG -> CAAACGAATAGCATGAGGT
CCGGCTGATCGCGACTGAG -> CGGCTGATCGCGACTGAGC
TCGATATAATACTACAGGT -> CGATATAATACTACAGGTC
GTGGGTCAGTACAATTGGG -> TGGGTCAGTACAATTGGGC
AGGATTATGTTTATTACCG -> GGATTATGTTTATTACCGG
GCAACCATCTTGCCCCACC -> CAACCATCTTGCCCCACCG
CCTTCGCGACCCAACTACG -> CTTCGCGACCCAACTACGC
ATAACAAGGTGCCCGTCAT -> TAACAAGGTGCCCGTCATT
TATTGGGCAGCTGTGGGTG -> ATTGGGCAGCTGTGGGTGG
TCCCATTGGAAAAACTGAT -> CCCATTGGAAAAACTGATG
GTTCTTGTTACATTTGATG -> TTCTTGTTACATTTGATGT
ATCGTATAAATGCAACAAG -> TCGTATAAATGCAACAAGT
CGTGCACGAAGTCAAGATC -> GTGCACGAAGTCAAGATCT
AGACTCGCAGTTTCTGTTG -> GACTCGCAGTTTCTGTTGG
CATTAATGGTCGCCTCTGC -> ATTAATGGTCGCCTCTGCG
TTCACGGGGATCCTATCAC -> TCACGGGGATCCTATCACC
TGTTCCAAGCGTGTGGAGA -> GTTCCAAGCGTGTGGAGAG
AGCACGGCGCATTAATGGT -> GCACGGCGCATTAATGGTC
CTTACGAAAAAATCATGAT -> TTACGAAAAAATCATGATC
ACTCGCAGTAGATGGAGTG -> CTCGCAGTAGATGGAGTGC
GTGGAACGGGCCGCTGAGA -> TGGAACGGGCCGCTGAGAC
CTACGTGTCTAGACTCGCA -> TACGTGTCTAGACTCGCAG
TACCATAAAGTTCTTCTGG -> ACCATAAAGTTCTTCTGGT
CACGAAGTCAAGATCTAGA -> ACGAAGTCAAGATCTAGAG
GTAGGTGGATATGTCAAAT -> TAGGTGGATATGTCAAATT
ACATGGCTCTGACGATGGT -> CATGGCTCTGACGATGGTA
CTTGTTACATTAGTGGCAT -> TTGTTACATTAGTGGCATA
ACTAGGCGGTGCCCGCACT -> CTAGGCGGTGCCCGCACTC
TAGATGGAGTGCCGAATGA -> AGATGGAGTGCCGAATGAA
TTGGAGCATGGACTTCACT -> TGGAGCATGGACTTCACTT
CTTGTTACATTTGATGTGT -> TTGTTACATTTGATGTGTA
AGTGGCATAGGAGATTCAC -> GTGGCATAGGAGATTCACA
TCCGGACTCCCGTTCTTGT -> CCGGACTCCCGTTCTTGTT
CAGTCGTACCGTGCCTTCG -> AGTCGTACCGTGCCTTCGC
TTCCGTAAGCTAGGAACAC -> TCCGTAAGCTAGGAACACC
TTTGCCCCTCTCCGGGAAT -> TTGCCCCTCTCCGGGAATG
CATGGAACGAATGAAATAA -> ATGGAACGAATGAAATAAG
TAGGAGTTCTGAGAGGTCG -> AGGAGTTCTGAGAGGTCGG
ACATTGAGGGCTTAGCAAC -> CATTGAGGGCTTAGCAACC
GGCTCGTAGCGGTCTCGAT -> GCTCGTAGCGGTCTCGATG
GGTCGTGCACGAAGTCAAG -> GTCGTGCACGAAGTCAAGA
AACGTATTGGCAAAAATCG -> ACGTATTGGCAAAAATCGA
CAGTCACAAACGAATAGCA -> AGTCACAAACGAATAGCAT
CTTCAAGGAGTTACCATAA -> TTCAAGGAGTTACCATAAA
TATTAGTGCATCAGGATTA -> ATTAGTGCATCAGGATTAT
TGATCGCGACTGAGCGCAT -> GATCGCGACTGAGCGCATA
ACCACCCCAAGCTCGCCCT -> CCACCCCAAGCTCGCCCTA
TAGAGTGGACCGCTCCGGA -> AGAGTGGACCGCTCCGGAT
ACGGATAACAAGGTGCCCG -> CGGATAACAAGGTGCCCGT
CGCATTAATGGTCGCCTCT -> GCATTAATGGTCGCCTCTG
AATAAACCGGCTGATCGCG -> ATAAACCGGCTGATCGCGA
GTGACAATGTCCCGCTCAT -> TGACAATGTCCCGCTCATG
ATGTGTCCCTCTCGTATAT -> TGTGTCCCTCTCGTATATT
CGCAGATTGCTTTCGGAAC -> GCAGATTGCTTTCGGAACA
GCCAGGAAGTACCACCACC -> CCAGGAAGTACCACCACCC
TCTCCGGGAATGAAATAAG -> CTCCGGGAATGAAATAAGA
GAGACCAGAATGAAATAAG -> AGACCAGAATGAAATAAGA
CTATAGAGTGGACCGCTCC -> TATAGAGTGGACCGCTCCG
GCATGGACTTCACTTCAAG -> CATGGACTTCACTTCAAGG
TTATTACCGGGTTTCTGAC -> TATTACCGGGTTTCTGACT
CGTCCCCTTCGACTAGTGC -> GTCCCCTTCGACTAGTGCG
TAGACTCGCAGTTTCTGTT -> AGACTCGCAGTTTCTGTTG
CAAGCTTCAGGTGACAATG -> AAGCTTCAGGTGACAATGT
CAACTGGTGCCTTCTTACG -> AACTGGTGCCTTCTTACGA
TACCGGGTTTCTGACTGGT -> ACCGGGTTTCTGACTGGTC
CCTGTGAGCTGTGCCCTGG -> CTGTGAGCTGTGCCCTGGA
TATTACCGGGTTTCTGACT -> ATTACCGGGTTTCTGACTG
AGGTCTGCCATTTACCATA -> GGTCTGCCATTTACCATAT
AGCAATTGCCATAGTCGGT -> GCAATTGCCATAGTCGGTG
ACTCTGGCGGACGGCTAAA -> CTCTGGCGGACGGCTAAAT
TCTTCCCATTGGAAAAACT -> CTTCCCATTGGAAAAACTG
GTGAGCTGTGCCCTGGAAC -> TGAGCTGTGCCCTGGAACC
CGTTCAAACCACACCCGAC -> GTTCAAACCACACCCGACA
TTGGGCCTGCTTGAACAGT -> TGGGCCTGCTTGAACAGTC
GACCGCTCCGGATGTTGCA -> ACCGCTCCGGATGTTGCAG
TATACACCGTGAATAAACC -> ATACACCGTGAATAAACCG
TCGCAGTTTCTGTTGGTAG -> CGCAGTTTCTGTTGGTAGC
ATCTACGATCTTCCTGTTC -> TCTACGATCTTCCTGTTCC
AAGTTCTTCTGGTCGAATT -> AGTTCTTCTGGTCGAATTA
CGGAACAATCGGCAGAGAT -> GGAACAATCGGCAGAGATC
TACGGGTGCGAATGTCGGG -> ACGGGTGCGAATGTCGGGT
ACTTTCATACATGGCTCTG -> CTTTCATACATGGCTCTGA
TATGTCAAATTATCTGCAT -> ATGTCAAATTATCTGCATT
GGTGCGAATGTCGGGTGAA -> GTGCGAATGTCGGGTGAAG
ATTCTATCCTCGTTTTGTC -> TTCTATCCTCGTTTTGTCG
GACTAGGATTTGTGCGGCC -> ACTAGGATTTGTGCGGCCT
AGACTAGGTTGCCTGCGGT -> GACTAGGTTGCCTGCGGTC
TGGCTGCACGTGCTATACA -> GGCTGCACGTGCTATACAC
TGCGGTGGAACGGGCCGCT -> GCGGTGGAACGGGCCGCTG
ACAGTGTCTATACGGACAA -> CAGTGTCTATACGGACAAT
TGCCCGTCATTCTGTTAGG -> GCCCGTCATTCTGTTAGGT
ATAATACTACAGGTCACAG -> TAATACTACAGGTCACAGC
AGCATAACAAGACGGCGTA -> GCATAACAAGACGGCGTAG
CAAAAAGGGGCTGTAGTAG -> AAAAAGGGGCTGTAGTAGG
CTGGCGGACGGCTAAATCG -> TGGCGGACGGCTAAATCGC
CAGTGCTCCCGTAGAAACT -> AGTGCTCCCGTAGAAACTA
TACGACTTCACGGGGATCC -> ACGACTTCACGGGGATCCT
CGCACGTCCCCTTCGACTA -> GCACGTCCCCTTCGACTAG
ACCGGGTTTCTGACTGGTC -> CCGGGTTTCTGACTGGTCG
CTACTCGCAGTAGATGGAG -> TACTCGCAGTAGATGGAGT
GGCTCCGCAGTGCTCCCGT -> GCTCCGCAGTGCTCCCGTA
TGACAATGTCCCGCTCATG -> GACAATGTCCCGCTCATGT
TATGGTGCATAGCCTGTGA -> ATGGTGCATAGCCTGTGAG
GGATCCTATCACCGGTATA -> GATCCTATCACCGGTATAG
TTAAACCTTGTCCTTCTGT -> TAAACCTTGTCCTTCTGTC
TAAGAAAGGTGCGTGACTC -> AAGAAAGGTGCGTGACTCT
GGGGGGGTCGTGCACGAAG -> GGGGGGTCGTGCACGAAGT
TGCCTTCGCGACCCAACTA -> GCCTTCGCGACCCAACTAC
GACGGATCTCATCACCTCA -> ACGGATCTCATCACCTCAG
GAATTAGCAGTGTATAACC -> AATTAGCAGTGTATAACCA
TGTGAAATGCTTCGCATGG -> GTGAAATGCTTCGCATGGA
TTGCTCCGGACTCCCGTTC -> TGCTCCGGACTCCCGTTCT
AGCTACTCGCAGTAGATGG -> GCTACTCGCAGTAGATGGA
TACGCACGTCCCCTTCGAC -> ACGCACGTCCCCTTCGACT
CTTGTCCTTCTGTCGTAAA -> TTGTCCTTCTGTCGTAAAC
CAGCACTACTATTGGGTGA -> AGCACTACTATTGGGTGAC
TGCATTGTGGAACCCTTCC -> GCATTGTGGAACCCTTCCT
ACGGGCCGCTGAGACCAGA -> CGGGCCGCTGAGACCAGAA
CCGACGTCGTCACTACTTT -> CGACGTCGTCACTACTTTC
CCCGCTCATGTGTCCCTCT -> CCGCTCATGTGTCCCTCTC
AATTTAGCGGCCGCCAACG -> ATTTAGCGGCCGCCAACGT
AGCGAAGAATATGGTGCAT -> GCGAAGAATATGGTGCATA
CACGTCCCCTTCGACTAGT -> ACGTCCCCTTCGACTAGTG
GTCATTCTGTTAGGTATAC -> TCATTCTGTTAGGTATACG
GGTATACATATACCGTGGG -> GTATACATATACCGTGGGT
CTTCTTACGAAAAAATCAT -> TTCTTACGAAAAAATCATG
TTGATGGCTCCGCAGTGCT -> TGATGGCTCCGCAGTGCTC
GCATAGGAGATTCACATGT -> CATAGGAGATTCACATGTC
TGTGTCCCTCTCGTATATT -> GTGTCCCTCTCGTATATTG
CTTCTCCGTTCAAACCACA -> TTCTCCGTTCAAACCACAC
ACAGCACTGTATAGTAGCT -> CAGCACTGTATAGTAGCTA
GCCTCTGCGCAGATTGCTT -> CCTCTGCGCAGATTGCTTT
TGAACCAATGCTAAGATTA -> GAACCAATGCTAAGATTAG
GCACGGACACGTCATACGT -> CACGGACACGTCATACGTA
AAAGTCTATTCTATCCTCG -> AAGTCTATTCTATCCTCGT
AGACTAGGATTTGTGCGGC -> GACTAGGATTTGTGCGGCC
TTACCATATGCGAAAACAG -> TACCATATGCGAAAACAGA
GCAATTGCCATAGTCGGTG -> CAATTGCCATAGTCGGTGA
TAATGGTCGCCTCTGCGCA -> AATGGTCGCCTCTGCGCAG
GGTGCCCGTCATTCTGTTA -> GTGCCCGTCATTCTGTTAG
GATATGTCAAATTATCTGC -> ATATGTCAAATTATCTGCA
CAGGTGACAATGTCCCGCT -> AGGTGACAATGTCCCGCTC
TGAAGCGAAGAATATGGTG -> GAAGCGAAGAATATGGTGC
AATCGGCAGAGATCTATTA -> ATCGGCAGAGATCTATTAG
CTGTGCAATTTCAATCTTG -> TGTGCAATTTCAATCTTGG
TCGTAAACAGCACGGCGCA -> CGTAAACAGCACGGCGCAT
TTCTATCCTCGTTTTGTCG -> TCTATCCTCGTTTTGTCGG
TATTCTATCCTCGTTTTGT -> ATTCTATCCTCGTTTTGTC
GTGGGACTTAGGGCTCGTA -> TGGGACTTAGGGCTCGTAG
AACCGGGGGGGAACGCAAT -> ACCGGGGGGGAACGCAATT
TACCACCACCCCAAGCTCG -> ACCACCACCCCAAGCTCGC
CAGTACAATTGGGCTGTAT -> AGTACAATTGGGCTGTATT
GTTACGGGTGCGAATGTCG -> TTACGGGTGCGAATGTCGG
GGTGGGACTTAGGGCTCGT -> GTGGGACTTAGGGCTCGTA
ACGATCTTCCTGTTCCTTA -> CGATCTTCCTGTTCCTTAT
CCACCGCCGGTGAAGCCAG -> CACCGCCGGTGAAGCCAGG
CGTTCTTGTTACATTAGTG -> GTTCTTGTTACATTAGTGG
ACATCCTAATACAGTGTCT -> CATCCTAATACAGTGTCTA
GGTCGCCTCTGCGCAGATT -> GTCGCCTCTGCGCAGATTG
AAACTTCGTCCAAAAAGGG -> AACTTCGTCCAAAAAGGGG
CCCGTCATTCTGTTAGGTA -> CCGTCATTCTGTTAGGTAT
ATGTCAAATTATCTGCATT -> TGTCAAATTATCTGCATTG
CGACGTCGTCACTACTTTC -> GACGTCGTCACTACTTTCA
TGTCAAATTATCTGCATTG -> GTCAAATTATCTGCATTGT
ACAGGGTGCACAAACCGGG -> CAGGGTGCACAAACCGGGG
AATGCTAAGATTAGTTCGG -> ATGCTAAGATTAGTTCGGA
CCTGTGATAAACTTCGTCC -> CTGTGATAAACTTCGTCCA
CTCGTTTTGTCGGAGGAGT -> TCGTTTTGTCGGAGGAGTC
GACGATGGTATTGGGCAGC -> ACGATGGTATTGGGCAGCT
GAAATAAGACTAGGCGGTG -> AAATAAGACTAGGCGGTGC
GTCGGGGGGGTCGTGCACG -> TCGGGGGGGTCGTGCACGA
TGCGCAGATTGCTTTCGGA -> GCGCAGATTGCTTTCGGAA
TCTGTCGTAAACAGCACGG -> CTGTCGTAAACAGCACGGC
CTATCACCGGTATAGCAAT -> TATCACCGGTATAGCAATT
